šifra opštine,opstina,biračko mesto,adress,Broj primljenih glasačkih listića,Broj neupotrebljenih glasačkih listića,Broj birača upisanih u birački spisak*,Broj birača koji su izašli na izbore,Broj birača koji su glasali,Broj nevažećih glasačkih listića,broj važećih glasačkih listića,Tomislav Nikolić,Boris Tadić
33001,Australija,1,,128,68,128,60,60,0,60,15,45
33002,Austrija,1,,645,239,641,406,406,6,400,128,272
33002,Austrija,2,,208,114,208,94,94,0,94,39,55
33002,Austrija,3,,108,79,107,29,29,1,28,10,18
33003,Belgija,1,,112,40,112,72,72,2,70,6,64
33004,Velika Britanija,1,,311,129,311,182,182,1,181,24,157
33005,Grčka,1,,125,70,125,55,55,0,55,7,48
33006,Italija,1,,209,124,208,85,85,2,83,8,75
33006,Italija,2,,144,62,143,82,82,0,82,12,70
33006,Italija,3,,182,109,181,73,73,0,73,19,54
33007,Kanada,1,,266,156,264,110,110,0,110,28,82
33008,Kipar,1,,126,83,126,43,43,1,42,5,37
33009,Libija,1,,133,54,132,79,79,1,78,28,50
33011,Ruska Federacija,1,,796,586,790,210,210,3,207,55,152
33012,Savezna Republika Nemačka,1,,240,84,238,156,156,0,156,54,102
33012,Savezna Republika Nemačka,2,,287,101,285,186,186,2,184,83,101
33012,Savezna Republika Nemačka,3,,227,76,227,151,151,0,151,55,96
33012,Savezna Republika Nemačka,4,,358,126,356,232,232,1,231,62,169
33012,Savezna Republika Nemačka,5,,154,75,153,79,79,0,79,27,52
33012,Savezna Republika Nemačka,6,,404,109,401,295,295,0,295,121,174
33013,Sjedinjene Američke Države,1,,138,54,137,84,84,0,84,5,79
33013,Sjedinjene Američke Države,2,,187,116,186,71,71,0,71,7,64
33013,Sjedinjene Američke Države,3,,130,56,129,74,74,2,72,5,67
33014,Slovačka,1,,118,68,50,50,50,0,50,10,40
33015,Francuska,1,,644,224,640,420,420,5,415,147,268
33015,Francuska,2,,479,163,475,316,316,4,312,131,181
33015,Francuska,3,,106,58,105,48,48,0,48,25,23
33015,Francuska,4,,123,59,123,64,64,1,63,19,44
33016,Holandija,1,,118,46,117,72,72,0,72,24,48
33017,Češka Republika,1,,124,42,123,82,82,1,81,2,79
33018,Švajcarska,1,,236,98,234,138,138,3,135,63,72
33018,Švajcarska,2,,370,139,367,231,231,1,230,71,159
33018,Švajcarska,3,,156,61,155,95,95,0,95,36,59
55001,Zavodi za izvršenje zavodskih sankcija,1,,923,328,923,595,595,7,588,430,158
55001,Zavodi za izvršenje zavodskih sankcija,2,,932,411,932,521,521,9,512,354,158
55001,Zavodi za izvršenje zavodskih sankcija,3,,1086,285,1086,801,801,19,782,571,211
55001,Zavodi za izvršenje zavodskih sankcija,4,,608,196,608,412,412,31,381,297,84
55001,Zavodi za izvršenje zavodskih sankcija,5,,363,168,363,195,195,4,191,129,62
55001,Zavodi za izvršenje zavodskih sankcija,6,,251,76,251,175,175,2,173,140,33
55001,Zavodi za izvršenje zavodskih sankcija,7,,170,61,171,109,109,4,105,71,34
55001,Zavodi za izvršenje zavodskih sankcija,8,,169,54,169,115,115,3,112,74,38
55001,Zavodi za izvršenje zavodskih sankcija,9,,151,39,151,112,112,2,110,42,68
55001,Zavodi za izvršenje zavodskih sankcija,10,,125,20,125,105,105,1,104,85,19
55001,Zavodi za izvršenje zavodskih sankcija,11,,142,48,142,94,94,4,90,59,31
55001,Zavodi za izvršenje zavodskih sankcija,12,,116,33,116,83,83,1,82,62,20
55001,Zavodi za izvršenje zavodskih sankcija,14,,106,29,106,77,77,1,76,57,19
55001,Zavodi za izvršenje zavodskih sankcija,15,,109,29,109,80,80,2,78,43,35
55001,Zavodi za izvršenje zavodskih sankcija,16,,108,22,108,86,86,5,81,57,24
70017,Aleksandrovac,1,,249,100,249,149,149,7,142,64,78
70017,Aleksandrovac,2,,154,87,154,67,67,2,65,57,8
70017,Aleksandrovac,3,,261,173,261,88,88,1,87,58,29
70017,Aleksandrovac,4,,438,296,439,142,142,1,141,126,15
70017,Aleksandrovac,5,,184,92,184,92,92,2,90,54,36
70017,Aleksandrovac,6,,303,174,303,129,129,2,127,99,28
70017,Aleksandrovac,7,,332,198,332,134,134,1,133,58,75
70017,Aleksandrovac,8,,154,83,154,71,71,0,71,42,29
70017,Aleksandrovac,9,,128,72,128,56,56,6,50,15,35
70017,Aleksandrovac,10,,231,84,231,147,147,0,147,61,86
70017,Aleksandrovac,11,,136,90,136,46,46,2,44,20,24
70017,Aleksandrovac,12,,368,244,368,124,124,2,122,58,64
70017,Aleksandrovac,13,,154,83,154,71,71,1,70,37,33
70017,Aleksandrovac,14,,448,229,448,219,219,9,210,104,106
70017,Aleksandrovac,15,,283,140,283,143,143,6,137,88,49
70017,Aleksandrovac,16,,175,87,175,88,88,2,86,44,42
70017,Aleksandrovac,17,,145,65,145,80,80,0,80,42,38
70017,Aleksandrovac,18,,242,137,242,105,105,3,102,58,44
70017,Aleksandrovac,19,,491,229,491,262,262,8,254,120,134
70017,Aleksandrovac,20,,347,185,347,162,162,3,159,109,50
70017,Aleksandrovac,21,,333,182,333,151,151,2,149,66,83
70017,Aleksandrovac,22,,315,180,315,135,135,2,133,62,71
70017,Aleksandrovac,23,,338,171,338,167,167,4,163,82,81
70017,Aleksandrovac,24,,299,151,299,148,148,5,143,77,66
70017,Aleksandrovac,25,,281,107,281,174,174,11,163,57,106
70017,Aleksandrovac,26,,227,109,227,118,118,3,115,38,77
70017,Aleksandrovac,27,,267,112,267,155,155,4,151,99,52
70017,Aleksandrovac,28,,315,162,315,153,153,5,148,77,71
70017,Aleksandrovac,29,,230,85,231,145,145,5,140,84,56
70017,Aleksandrovac,30,,396,223,396,173,173,4,169,98,71
70017,Aleksandrovac,31,,246,93,246,153,153,4,149,86,63
70017,Aleksandrovac,32,,611,305,611,306,306,6,300,156,144
70017,Aleksandrovac,33,,404,208,404,196,196,3,193,109,84
70017,Aleksandrovac,34,,248,117,248,131,131,0,131,64,67
70017,Aleksandrovac,35,,591,290,591,301,301,11,290,149,141
70017,Aleksandrovac,36,,330,109,330,221,221,5,216,98,118
70017,Aleksandrovac,37,,920,574,920,346,346,5,341,175,166
70017,Aleksandrovac,38,,560,216,560,344,344,2,342,180,162
70017,Aleksandrovac,39,,441,251,441,190,190,2,188,122,66
70017,Aleksandrovac,40,,252,140,252,112,112,1,111,56,55
70017,Aleksandrovac,41,,712,398,712,314,314,4,310,178,132
70017,Aleksandrovac,42,,429,220,429,209,209,7,202,85,117
70017,Aleksandrovac,43,,175,97,175,78,78,2,76,40,36
70017,Aleksandrovac,44,,280,119,280,161,161,1,160,28,132
70017,Aleksandrovac,45,,339,227,340,112,112,2,110,46,64
70017,Aleksandrovac,46,,113,74,113,39,39,2,37,14,23
70017,Aleksandrovac,47,,197,94,197,103,103,6,97,40,57
70017,Aleksandrovac,48,,444,283,444,161,161,1,160,80,80
70017,Aleksandrovac,49,,198,122,198,76,76,0,76,26,50
70017,Aleksandrovac,50,,706,460,706,246,246,6,240,121,119
70017,Aleksandrovac,51,,178,91,178,87,87,1,86,51,35
70017,Aleksandrovac,52,,739,510,739,229,229,4,225,122,103
70017,Aleksandrovac,53,,881,443,883,438,438,12,426,187,239
70017,Aleksandrovac,54,,952,483,952,469,469,10,459,186,273
70017,Aleksandrovac,55,,1194,672,1197,522,522,8,514,221,293
70017,Aleksandrovac,56,,1238,702,1238,536,536,13,523,215,308
70017,Aleksandrovac,57,,259,120,259,139,139,7,132,41,91
70017,Aleksandrovac,58,,612,429,613,183,183,4,179,129,50
70017,Aleksandrovac,59,,564,298,564,266,266,7,259,116,143
70017,Aleksandrovac,60,,1981,1274,1984,707,707,21,686,298,388
70025,Aleksinac,1,,296,149,296,147,147,0,147,115,32
70025,Aleksinac,2,,420,293,420,127,127,3,124,60,64
70025,Aleksinac,3,,216,43,216,173,173,0,173,93,80
70025,Aleksinac,4,,295,143,295,152,152,0,152,116,36
70025,Aleksinac,5,,537,368,537,169,169,2,167,83,84
70025,Aleksinac,6,,210,128,210,82,82,0,82,57,25
70025,Aleksinac,7,,659,412,659,247,247,6,241,147,94
70025,Aleksinac,8,,101,47,101,54,54,1,53,52,1
70025,Aleksinac,9,,185,95,185,90,90,1,89,68,21
70025,Aleksinac,10,,188,88,188,100,100,2,98,55,43
70025,Aleksinac,11,,486,315,486,171,171,3,168,131,37
70025,Aleksinac,12,,303,196,303,107,107,2,105,70,35
70025,Aleksinac,13,,1168,759,1172,409,409,3,406,274,132
70025,Aleksinac,14,,638,375,639,263,263,3,260,185,75
70025,Aleksinac,15,,125,49,125,76,76,0,76,60,16
70025,Aleksinac,16,,889,544,889,345,345,12,333,194,139
70025,Aleksinac,17,,981,509,981,472,472,8,464,347,117
70025,Aleksinac,18,,270,134,270,136,136,3,133,87,46
70025,Aleksinac,19,,272,121,272,151,151,4,147,124,23
70025,Aleksinac,20,,644,354,644,290,290,4,286,144,142
70025,Aleksinac,21,,786,438,786,348,348,3,345,182,163
70025,Aleksinac,22,,960,530,960,430,430,5,425,309,116
70025,Aleksinac,23,,746,418,746,328,328,4,324,237,87
70025,Aleksinac,24,,755,465,755,290,290,6,284,226,58
70025,Aleksinac,25,,163,102,163,61,61,1,60,51,9
70025,Aleksinac,26,,589,364,589,225,224,2,222,155,67
70025,Aleksinac,27,,689,449,689,240,240,4,236,157,79
70025,Aleksinac,28,,168,93,168,75,75,0,75,45,30
70025,Aleksinac,29,,735,419,735,316,316,9,307,204,103
70025,Aleksinac,30,,617,386,617,231,231,4,227,153,74
70025,Aleksinac,31,,130,58,130,72,72,1,71,58,13
70025,Aleksinac,32,,552,321,552,231,231,2,229,152,77
70025,Aleksinac,33,,372,195,372,177,177,4,173,139,34
70025,Aleksinac,34,,293,131,293,162,162,4,158,107,51
70025,Aleksinac,35,,195,104,195,91,91,1,90,49,41
70025,Aleksinac,36,,124,61,124,63,63,0,63,41,22
70025,Aleksinac,37,,366,201,366,165,165,14,151,102,49
70025,Aleksinac,38,,100,53,100,47,47,0,47,27,20
70025,Aleksinac,39,,167,101,167,66,66,0,66,45,21
70025,Aleksinac,40,,103,52,103,51,51,4,47,29,18
70025,Aleksinac,41,,177,66,177,111,111,2,109,67,42
70025,Aleksinac,42,,322,196,322,126,126,0,126,63,63
70025,Aleksinac,43,,577,422,573,155,155,3,152,110,42
70025,Aleksinac,44,,145,61,145,84,84,1,83,65,18
70025,Aleksinac,45,,714,507,714,207,207,0,207,106,101
70025,Aleksinac,46,,659,502,659,157,157,2,155,82,73
70025,Aleksinac,47,,846,526,846,320,320,11,309,236,73
70025,Aleksinac,48,,454,265,464,189,189,2,187,146,41
70025,Aleksinac,49,,168,106,168,62,62,1,61,28,33
70025,Aleksinac,50,,145,55,145,90,90,2,88,58,30
70025,Aleksinac,51,,395,245,395,150,150,1,149,89,60
70025,Aleksinac,52,,283,180,283,103,102,2,100,85,15
70025,Aleksinac,53,,920,654,920,266,266,4,262,171,91
70025,Aleksinac,54,,882,548,882,334,334,0,334,230,104
70025,Aleksinac,55,,193,100,193,93,93,0,93,60,33
70025,Aleksinac,56,,1197,551,1197,646,646,12,634,396,238
70025,Aleksinac,57,,951,543,958,408,408,3,405,194,211
70025,Aleksinac,58,,824,356,827,468,468,11,457,197,260
70025,Aleksinac,59,,768,419,768,349,349,7,342,189,153
70025,Aleksinac,60,,686,345,686,341,340,7,333,195,138
70025,Aleksinac,61,,863,398,863,465,465,12,453,205,248
70025,Aleksinac,62,,947,431,947,516,516,9,507,297,210
70025,Aleksinac,63,,845,371,845,474,474,16,458,201,257
70025,Aleksinac,64,,680,348,680,332,332,7,325,172,153
70025,Aleksinac,65,,770,381,770,389,389,4,385,178,207
70025,Aleksinac,66,,766,387,766,379,379,13,366,164,202
70025,Aleksinac,67,,795,406,795,389,389,5,384,183,201
70025,Aleksinac,68,,829,413,829,416,416,8,408,208,200
70025,Aleksinac,69,,1016,561,1017,455,455,10,445,258,187
70025,Aleksinac,70,,1018,475,1018,543,543,7,536,294,242
70025,Aleksinac,71,,930,450,930,480,480,7,473,254,219
70025,Aleksinac,72,,795,369,795,426,426,9,417,244,173
70025,Aleksinac,73,,619,409,619,210,210,0,210,133,77
70025,Aleksinac,74,,964,423,963,541,541,17,524,277,247
70025,Aleksinac,75,,747,394,747,353,353,4,349,264,85
70025,Aleksinac,76,,452,239,452,213,213,4,209,163,46
70025,Aleksinac,77,,677,310,676,367,367,3,364,280,84
70025,Aleksinac,78,,458,215,458,243,243,3,240,161,79
70025,Aleksinac,79,,453,287,453,166,166,6,160,104,56
70025,Aleksinac,80,,308,188,308,120,120,1,119,91,28
70025,Aleksinac,81,,322,189,322,133,133,3,130,93,37
70025,Aleksinac,82,,192,120,200,72,72,2,70,53,17
70025,Aleksinac,83,,133,84,133,49,49,1,48,41,7
70025,Aleksinac,84,,244,46,244,198,198,1,197,188,9
70025,Aleksinac,85,,801,453,780,348,348,6,342,229,113
70025,Aleksinac,86,,279,164,279,115,115,3,112,87,25
70025,Aleksinac,87,,219,60,219,159,159,2,157,109,48
70025,Aleksinac,88,,415,199,415,216,216,0,216,161,55
70025,Aleksinac,89,,132,68,132,64,64,1,63,53,10
70025,Aleksinac,90,,317,175,317,142,142,0,142,105,37
70025,Aleksinac,91,,296,179,296,117,117,2,115,102,13
70033,Aranđelovac,1,,1568,731,1569,837,837,15,822,481,341
70033,Aranđelovac,2,,1327,615,1328,712,710,11,699,329,370
70033,Aranđelovac,3,,2085,1081,2085,1004,1004,11,993,423,570
70033,Aranđelovac,4,,1415,663,1416,752,752,10,742,299,443
70033,Aranđelovac,5,,1002,468,1002,534,534,4,530,227,303
70033,Aranđelovac,6,,403,179,403,224,224,2,222,94,128
70033,Aranđelovac,7,,1636,826,1637,810,810,6,804,349,455
70033,Aranđelovac,8,,1446,642,1446,804,804,15,789,340,449
70033,Aranđelovac,9,,1646,750,1647,896,896,13,883,369,514
70033,Aranđelovac,10,,1930,952,1931,978,978,17,961,516,445
70033,Aranđelovac,11,,887,438,887,449,448,3,445,207,238
70033,Aranđelovac,12,,1296,655,1298,641,641,9,632,267,365
70033,Aranđelovac,13,,1828,917,1828,911,911,15,896,465,431
70033,Aranđelovac,14,,812,339,812,473,473,10,463,179,284
70033,Aranđelovac,15,,1371,807,1371,564,564,10,554,329,225
70033,Aranđelovac,16,,1492,829,1492,663,663,5,658,372,286
70033,Aranđelovac,17,,1397,761,1397,636,636,7,629,343,286
70033,Aranđelovac,18,,809,505,809,304,304,2,302,179,123
70033,Aranđelovac,19,,866,507,866,359,359,7,352,208,144
70033,Aranđelovac,20,,494,276,494,218,218,0,218,123,95
70033,Aranđelovac,21,,647,379,647,268,268,4,264,160,104
70033,Aranđelovac,22,,1032,616,1032,416,416,5,411,252,159
70033,Aranđelovac,23,,1091,668,1092,423,423,6,417,244,173
70033,Aranđelovac,24,,640,337,640,303,303,6,297,124,173
70033,Aranđelovac,25,,478,296,478,182,181,1,180,89,91
70033,Aranđelovac,26,,323,184,323,139,139,7,132,60,72
70033,Aranđelovac,27,,466,275,466,191,191,4,187,101,86
70033,Aranđelovac,28,,484,300,484,184,184,3,181,82,99
70033,Aranđelovac,29,,373,218,373,155,155,2,153,103,50
70033,Aranđelovac,30,,738,478,739,260,260,1,259,149,110
70033,Aranđelovac,31,,585,384,585,201,201,9,192,111,81
70033,Aranđelovac,32,,666,307,666,359,359,8,351,177,174
70033,Aranđelovac,33,,487,249,486,238,238,2,236,165,71
70033,Aranđelovac,34,,384,186,384,198,198,4,194,85,109
70033,Aranđelovac,35,,377,135,377,242,242,6,236,121,115
70033,Aranđelovac,36,,179,103,179,76,76,0,76,49,27
70033,Aranđelovac,37,,247,89,247,158,158,2,156,110,46
70033,Aranđelovac,38,,697,470,697,227,227,1,226,146,80
70033,Aranđelovac,39,,617,388,617,229,229,2,227,169,58
70033,Aranđelovac,40,,905,484,905,421,421,11,410,233,177
70033,Aranđelovac,41,,450,292,450,158,158,1,157,88,69
70033,Aranđelovac,42,,662,397,663,265,265,1,264,148,116
70033,Aranđelovac,43,,527,330,527,197,197,2,195,109,86
70041,Arilje,1,,824,374,824,450,450,6,444,175,269
70041,Arilje,2,,646,266,646,380,380,8,372,117,255
70041,Arilje,3,,609,324,609,285,285,11,274,113,161
70041,Arilje,4,,413,209,413,204,204,3,201,98,103
70041,Arilje,5,,522,249,522,273,273,4,269,127,142
70041,Arilje,6,,560,337,563,223,223,4,219,102,117
70041,Arilje,7,,574,304,574,270,270,4,266,132,134
70041,Arilje,8,,440,248,440,192,192,4,188,100,88
70041,Arilje,9,,496,270,496,226,226,1,225,99,126
70041,Arilje,10,,439,226,439,213,213,3,210,111,99
70041,Arilje,11,,121,57,121,64,64,0,64,29,35
70041,Arilje,12,,541,315,541,226,226,2,224,105,119
70041,Arilje,13,,486,253,486,233,233,5,228,111,117
70041,Arilje,14,,475,238,475,237,237,7,230,126,104
70041,Arilje,15,,403,266,403,137,137,1,136,89,47
70041,Arilje,16,,646,369,646,277,277,5,272,129,143
70041,Arilje,17,,677,305,677,372,372,2,370,140,230
70041,Arilje,18,,561,260,561,301,301,3,298,122,176
70041,Arilje,19,,305,155,305,150,150,3,147,85,62
70041,Arilje,20,,243,134,243,109,109,2,107,49,58
70041,Arilje,21,,414,246,414,168,168,3,165,97,68
70041,Arilje,22,,248,158,248,90,90,3,87,57,30
70041,Arilje,23,,385,207,385,178,178,2,176,112,64
70041,Arilje,24,,296,168,296,128,128,3,125,58,67
70041,Arilje,25,,654,430,654,224,224,5,219,101,118
70041,Arilje,26,,723,355,723,368,368,12,356,146,210
70041,Arilje,27,,311,172,311,139,139,1,138,60,78
70041,Arilje,28,,298,157,298,141,141,0,141,89,52
70041,Arilje,29,,248,122,248,126,126,1,125,65,60
70041,Arilje,30,,403,219,403,184,184,3,181,84,97
70041,Arilje,31,,338,184,338,154,154,3,151,73,78
70041,Arilje,32,,398,256,398,142,142,0,142,87,55
70041,Arilje,33,,334,206,334,128,128,0,128,71,57
70041,Arilje,34,,492,247,492,245,245,1,244,103,141
70041,Arilje,35,,415,210,415,205,205,12,193,88,105
70050,Babušnica,1,,582,309,582,273,273,8,265,138,127
70050,Babušnica,2,,525,270,525,255,255,3,252,136,116
70050,Babušnica,3,,463,244,463,219,219,1,218,121,97
70050,Babušnica,4,,516,312,515,204,204,1,203,116,87
70050,Babušnica,5,,507,296,507,211,211,1,210,104,106
70050,Babušnica,6,,482,258,482,224,224,1,223,125,98
70050,Babušnica,7,,432,249,432,183,183,5,178,122,56
70050,Babušnica,8,,456,278,456,178,178,6,172,124,48
70050,Babušnica,9,,418,219,418,199,199,6,193,115,78
70050,Babušnica,10,,181,105,181,76,76,3,73,61,12
70050,Babušnica,11,,229,136,229,93,93,2,91,62,29
70050,Babušnica,12,,153,110,153,43,43,0,43,36,7
70050,Babušnica,13,,101,48,101,53,53,1,52,39,13
70050,Babušnica,14,,236,101,236,135,135,5,130,77,53
70050,Babušnica,15,,157,124,157,33,33,0,33,27,6
70050,Babušnica,16,,246,132,246,114,114,1,113,100,13
70050,Babušnica,17,,134,56,134,78,78,0,78,61,17
70050,Babušnica,18,,135,57,135,78,78,0,78,67,11
70050,Babušnica,19,,101,29,101,72,72,0,72,61,11
70050,Babušnica,20,,100,68,100,32,32,0,32,25,7
70050,Babušnica,21,,312,158,312,154,154,5,149,57,92
70050,Babušnica,22,,269,102,269,167,167,1,166,129,37
70050,Babušnica,23,,154,72,154,82,82,2,80,68,12
70050,Babušnica,24,,162,95,162,67,67,0,67,51,16
70050,Babušnica,25,,294,146,294,148,148,2,146,110,36
70050,Babušnica,26,,231,124,231,107,107,4,103,62,41
70050,Babušnica,27,,167,91,167,76,76,2,74,50,24
70050,Babušnica,28,,356,181,356,175,175,3,172,139,33
70050,Babušnica,29,,116,65,116,51,51,1,50,35,15
70050,Babušnica,30,,111,47,111,64,64,1,63,49,14
70050,Babušnica,31,,407,253,407,154,154,4,150,100,50
70050,Babušnica,32,,236,132,236,104,104,2,102,84,18
70050,Babušnica,33,,197,127,197,70,70,2,68,57,11
70050,Babušnica,34,,384,213,385,171,171,2,169,127,42
70050,Babušnica,35,,450,263,450,187,187,3,184,127,57
70050,Babušnica,36,,390,220,390,170,170,0,170,120,50
70050,Babušnica,37,,285,139,286,146,146,0,146,78,68
70050,Babušnica,38,,232,97,232,135,135,2,133,117,16
70050,Babušnica,39,,266,109,266,157,157,7,150,104,46
70050,Babušnica,40,,167,69,167,98,98,5,93,73,20
70050,Babušnica,41,,350,161,350,189,189,1,188,126,62
70050,Babušnica,42,,177,87,177,90,90,1,89,76,13
70050,Babušnica,43,,301,161,301,140,140,1,139,81,58
70050,Babušnica,44,,220,97,222,123,123,4,119,52,67
70050,Babušnica,45,,214,109,214,105,105,0,105,48,57
70050,Babušnica,46,,123,40,123,83,83,1,82,61,21
70050,Babušnica,47,,162,88,162,74,74,2,72,60,12
70050,Babušnica,48,,115,48,115,67,67,1,66,38,28
70068,Bajina Bašta,1,,779,357,779,422,422,9,413,194,219
70068,Bajina Bašta,2,,759,405,759,354,354,6,348,172,176
70068,Bajina Bašta,3,,895,413,895,482,482,6,476,237,239
70068,Bajina Bašta,4,,785,407,785,378,378,5,373,187,186
70068,Bajina Bašta,5,,1021,505,1021,516,516,13,503,179,324
70068,Bajina Bašta,6,,631,292,631,339,338,9,329,114,215
70068,Bajina Bašta,7,,1332,651,1333,681,681,8,673,262,411
70068,Bajina Bašta,8,,988,516,988,472,472,2,470,262,208
70068,Bajina Bašta,9,,366,196,366,170,170,3,167,71,96
70068,Bajina Bašta,10,,107,40,107,67,67,2,65,20,45
70068,Bajina Bašta,11,,139,80,139,59,59,2,57,32,25
70068,Bajina Bašta,12,,475,193,475,282,282,4,278,177,101
70068,Bajina Bašta,13,,521,308,521,213,213,4,209,124,85
70068,Bajina Bašta,14,,541,335,541,206,206,4,202,113,89
70068,Bajina Bašta,15,,305,112,305,193,193,1,192,111,81
70068,Bajina Bašta,16,,173,72,173,101,101,0,101,66,35
70068,Bajina Bašta,17,,161,108,161,53,53,0,53,33,20
70068,Bajina Bašta,18,,384,271,384,113,113,6,107,53,54
70068,Bajina Bašta,19,,156,68,156,88,88,0,88,66,22
70068,Bajina Bašta,20,,253,141,253,112,112,4,108,63,45
70068,Bajina Bašta,21,,100,50,100,50,50,2,48,37,11
70068,Bajina Bašta,22,,368,215,368,153,153,5,148,73,75
70068,Bajina Bašta,23,,381,265,381,116,116,0,116,75,41
70068,Bajina Bašta,24,,325,209,325,116,116,4,112,65,47
70068,Bajina Bašta,25,,320,171,320,149,149,2,147,89,58
70068,Bajina Bašta,26,,130,77,130,53,53,1,52,27,25
70068,Bajina Bašta,27,,370,268,370,102,102,3,99,79,20
70068,Bajina Bašta,28,,172,111,172,61,61,0,61,24,37
70068,Bajina Bašta,29,,123,78,123,45,45,2,43,22,21
70068,Bajina Bašta,30,,392,230,392,162,162,4,158,109,49
70068,Bajina Bašta,31,,137,97,137,40,40,0,40,30,10
70068,Bajina Bašta,32,,845,434,847,411,411,1,410,211,199
70068,Bajina Bašta,33,,944,521,944,423,423,6,417,245,172
70068,Bajina Bašta,34,,344,199,344,145,145,4,141,68,73
70068,Bajina Bašta,35,,597,317,597,280,280,0,280,122,158
70068,Bajina Bašta,36,,444,293,444,151,151,1,150,86,64
70068,Bajina Bašta,37,,313,158,313,155,155,5,150,84,66
70068,Bajina Bašta,38,,187,105,187,82,82,2,80,38,42
70068,Bajina Bašta,39,,578,284,578,294,294,4,290,151,139
70068,Bajina Bašta,40,,341,217,341,124,124,0,124,78,46
70068,Bajina Bašta,41,,147,95,147,52,52,0,52,44,8
70068,Bajina Bašta,42,,384,259,384,125,125,4,121,64,57
70068,Bajina Bašta,43,,147,72,147,75,75,1,74,32,42
70068,Bajina Bašta,44,,244,159,244,85,85,3,82,52,30
70068,Bajina Bašta,45,,528,362,528,166,166,3,163,84,79
70068,Bajina Bašta,46,,338,187,337,151,151,1,150,78,72
70068,Bajina Bašta,47,,592,378,592,214,214,4,210,112,98
70068,Bajina Bašta,48,,169,119,170,50,50,1,49,39,10
70068,Bajina Bašta,49,,285,205,281,80,80,0,80,47,33
70068,Bajina Bašta,50,,297,143,297,154,154,4,150,77,73
70068,Bajina Bašta,51,,162,110,162,52,52,2,50,31,19
70068,Bajina Bašta,52,,170,84,170,86,86,0,86,56,30
70068,Bajina Bašta,53,,566,333,562,233,233,3,230,123,107
70076,Batočina,1,,121,56,121,65,65,0,65,23,42
70076,Batočina,2,,453,252,453,201,201,5,196,116,80
70076,Batočina,3,,191,68,191,123,123,1,122,60,62
70076,Batočina,4,,236,143,236,93,93,0,93,46,47
70076,Batočina,5,,237,157,237,80,80,0,80,25,55
70076,Batočina,6,,366,210,366,156,156,3,153,85,68
70076,Batočina,7,,217,115,217,102,102,0,102,48,54
70076,Batočina,8,,213,147,213,66,66,1,65,28,37
70076,Batočina,9,,260,156,260,104,104,2,102,40,62
70076,Batočina,10,,374,187,374,187,187,4,183,70,113
70076,Batočina,11,,290,152,290,138,138,1,137,51,86
70076,Batočina,12,,265,140,265,125,125,0,125,52,73
70076,Batočina,13,,210,96,210,114,114,2,112,50,62
70076,Batočina,14,,296,160,296,136,136,3,133,52,81
70076,Batočina,15,,279,144,279,135,135,2,133,64,69
70076,Batočina,16,,268,163,268,105,105,3,102,52,50
70076,Batočina,17,,296,165,296,131,131,0,131,87,44
70076,Batočina,18,,268,161,268,107,107,2,105,49,56
70076,Batočina,19,,242,134,242,108,108,1,107,23,84
70076,Batočina,20,,261,139,261,122,122,3,119,59,60
70076,Batočina,21,,363,209,363,154,154,3,151,79,72
70076,Batočina,22,,270,109,270,161,161,3,158,99,59
70076,Batočina,23,,338,170,338,168,168,3,165,109,56
70076,Batočina,24,,321,151,321,170,170,1,169,117,52
70076,Batočina,25,,361,164,361,197,197,2,195,125,70
70076,Batočina,26,,389,157,389,232,232,4,228,158,70
70076,Batočina,27,,342,182,342,160,160,2,158,108,50
70076,Batočina,28,,386,170,387,216,216,3,213,113,100
70076,Batočina,29,,333,126,333,207,207,8,199,72,127
70076,Batočina,30,,333,161,333,172,172,2,170,107,63
70076,Batočina,31,,411,210,411,201,201,0,201,139,62
70076,Batočina,32,,371,137,371,234,234,4,230,92,138
70076,Batočina,33,,346,149,346,197,197,4,193,93,100
70076,Batočina,34,,440,189,440,251,251,3,248,115,133
70076,Batočina,35,,431,185,431,246,246,4,242,97,145
70084,Bela Palanka,1,,293,147,293,146,146,8,138,73,65
70084,Bela Palanka,2,,521,292,521,229,229,3,226,108,118
70084,Bela Palanka,3,,405,125,405,280,280,6,274,148,126
70084,Bela Palanka,4,,372,173,372,199,199,8,191,100,91
70084,Bela Palanka,5,,297,91,297,206,206,6,200,108,92
70084,Bela Palanka,6,,436,190,436,246,246,7,239,122,117
70084,Bela Palanka,7,,512,275,512,237,237,4,233,141,92
70084,Bela Palanka,8,,293,127,293,166,166,3,163,71,92
70084,Bela Palanka,9,,404,165,404,239,239,3,236,123,113
70084,Bela Palanka,10,,376,172,377,204,204,5,199,106,93
70084,Bela Palanka,11,,627,317,627,310,310,5,305,201,104
70084,Bela Palanka,12,,461,256,461,205,205,3,202,128,74
70084,Bela Palanka,13,,469,239,470,230,230,5,225,143,82
70084,Bela Palanka,14,,510,240,510,270,270,4,266,151,115
70084,Bela Palanka,15,,312,149,312,163,163,3,160,105,55
70084,Bela Palanka,16,,379,189,379,190,190,5,185,134,51
70084,Bela Palanka,17,,111,77,111,34,34,0,34,23,11
70084,Bela Palanka,18,,244,164,244,80,80,1,79,47,32
70084,Bela Palanka,19,,224,84,225,140,140,3,137,100,37
70084,Bela Palanka,20,,151,47,151,104,104,1,103,67,36
70084,Bela Palanka,21,,271,139,271,132,132,3,129,88,41
70084,Bela Palanka,22,,202,108,202,94,94,1,93,46,47
70084,Bela Palanka,23,,190,78,191,112,112,8,104,48,56
70084,Bela Palanka,24,,155,73,155,82,82,0,82,52,30
70084,Bela Palanka,25,,264,136,264,128,128,4,124,99,25
70084,Bela Palanka,26,,156,114,156,42,42,1,41,25,16
70084,Bela Palanka,27,,447,305,447,142,142,1,141,104,37
70084,Bela Palanka,28,,188,137,188,51,51,0,51,28,23
70084,Bela Palanka,29,,116,52,116,64,64,1,63,43,20
70084,Bela Palanka,30,,369,223,369,146,146,2,144,99,45
70084,Bela Palanka,31,,124,84,124,40,40,0,40,31,9
70084,Bela Palanka,32,,137,45,137,92,92,3,89,55,34
70084,Bela Palanka,33,,102,38,102,64,64,1,63,21,42
70084,Bela Palanka,34,,425,256,425,169,169,2,167,135,32
70084,Bela Palanka,35,,221,109,221,112,112,2,110,74,36
70084,Bela Palanka,36,,194,97,194,97,97,1,96,50,46
70084,Bela Palanka,37,,173,85,173,88,88,6,82,54,28
70092,Barajevo,1,,708,417,708,291,291,4,287,128,159
70092,Barajevo,2,,1790,937,1790,853,853,10,843,437,406
70092,Barajevo,3,,472,261,472,211,211,1,210,128,82
70092,Barajevo,4,,579,313,579,266,266,2,264,163,101
70092,Barajevo,5,,700,417,700,283,283,3,280,135,145
70092,Barajevo,6,,718,394,718,324,324,4,320,186,134
70092,Barajevo,7,,870,422,870,448,448,6,442,247,195
70092,Barajevo,8,,638,266,638,372,372,6,366,162,204
70092,Barajevo,9,,684,370,684,314,314,4,310,176,134
70092,Barajevo,10,,731,354,731,377,377,12,365,207,158
70092,Barajevo,11,,1166,636,1166,530,530,7,523,234,289
70092,Barajevo,12,,1059,520,1059,539,539,10,529,256,273
70092,Barajevo,13,,769,386,769,383,383,4,379,234,145
70092,Barajevo,14,,601,323,601,278,278,0,278,160,118
70092,Barajevo,15,,616,327,616,289,289,8,281,167,114
70092,Barajevo,16,,559,311,559,248,247,8,239,140,99
70092,Barajevo,17,,467,235,467,232,232,0,232,114,118
70092,Barajevo,18,,1589,901,1589,688,688,15,673,341,332
70092,Barajevo,19,,649,350,649,299,299,2,297,171,126
70092,Barajevo,20,,1150,655,1150,495,495,5,490,271,219
70092,Barajevo,21,,413,231,413,182,182,4,178,118,60
70092,Barajevo,22,,614,341,614,273,273,4,269,150,119
70092,Barajevo,23,,528,322,528,206,206,2,204,128,76
70092,Barajevo,24,,1606,801,1606,805,805,5,800,488,312
70092,Barajevo,25,,416,218,416,198,198,0,198,90,108
70092,Barajevo,26,,599,350,599,249,249,8,241,103,138
70106,Voždovac,1,,2101,1141,2102,960,959,15,944,396,548
70106,Voždovac,2,,1381,617,1381,764,764,6,758,243,515
70106,Voždovac,3,,1334,597,1334,737,737,10,727,249,478
70106,Voždovac,4,,1268,613,1269,655,654,9,645,220,425
70106,Voždovac,5,,1768,952,1765,816,816,11,805,285,520
70106,Voždovac,6,,1368,655,1368,713,713,22,691,231,460
70106,Voždovac,7,,1889,864,1889,1025,1025,12,1013,404,609
70106,Voždovac,8,,2407,1154,2407,1253,1251,9,1242,412,830
70106,Voždovac,9,,2424,1185,2424,1239,1239,19,1220,465,755
70106,Voždovac,10,,1619,844,1619,775,775,19,756,302,454
70106,Voždovac,11,,957,458,960,499,499,6,493,189,304
70106,Voždovac,12,,1269,573,1269,696,696,8,688,263,425
70106,Voždovac,13,,1389,763,1389,626,626,10,616,243,373
70106,Voždovac,14,,1277,652,1277,625,623,6,617,149,468
70106,Voždovac,15,,1650,841,1650,809,809,12,797,259,538
70106,Voždovac,16,,1642,823,1642,819,819,24,795,263,532
70106,Voždovac,17,,1180,597,1180,583,583,5,578,158,420
70106,Voždovac,18,,1993,1008,1993,985,985,11,974,234,740
70106,Voždovac,19,,2055,960,2055,1095,1094,21,1073,264,809
70106,Voždovac,20,,2515,1301,2465,1214,1212,14,1198,336,862
70106,Voždovac,21,,2151,1066,2151,1085,1085,12,1073,344,729
70106,Voždovac,22,,2042,1061,2042,981,981,5,976,244,732
70106,Voždovac,23,,2106,1071,2106,1035,1033,15,1018,295,723
70106,Voždovac,24,,1264,626,1264,638,638,14,624,171,453
70106,Voždovac,25,,1101,634,1101,467,467,6,461,161,300
70106,Voždovac,26,,1202,637,1201,565,565,7,558,161,397
70106,Voždovac,27,,1425,680,1425,745,745,11,734,186,548
70106,Voždovac,28,,1761,936,1761,825,825,6,819,232,587
70106,Voždovac,29,,1720,920,1720,800,800,14,786,252,534
70106,Voždovac,30,,1919,1004,1919,915,912,11,901,280,621
70106,Voždovac,31,,1949,947,1949,1002,1002,16,986,273,713
70106,Voždovac,32,,2299,1192,2299,1107,1106,10,1096,377,719
70106,Voždovac,33,,2159,1110,2159,1049,1049,12,1037,332,705
70106,Voždovac,34,,2086,1045,2086,1041,1041,18,1023,302,721
70106,Voždovac,35,,1911,926,1911,985,985,11,974,323,651
70106,Voždovac,36,,2325,1102,2325,1223,1223,12,1211,336,875
70106,Voždovac,37,,2454,1083,2453,1371,1369,14,1355,346,1009
70106,Voždovac,38,,1923,1237,1923,686,686,15,671,296,375
70106,Voždovac,39,,1816,993,1816,823,822,10,812,267,545
70106,Voždovac,40,,1994,1125,1994,869,869,18,851,334,517
70106,Voždovac,41,,2329,1186,2329,1143,1143,5,1138,425,713
70106,Voždovac,42,,2065,1080,2065,985,983,12,971,353,618
70106,Voždovac,43,,1582,797,1582,785,785,11,774,270,504
70106,Voždovac,44,,1459,762,1459,697,697,7,690,288,402
70106,Voždovac,45,,1363,695,1363,668,668,9,659,251,408
70106,Voždovac,46,,2404,1445,2404,959,958,13,945,361,584
70106,Voždovac,47,,2108,1045,2108,1063,1063,16,1047,384,663
70106,Voždovac,48,,2162,1180,2164,982,982,11,971,377,594
70106,Voždovac,49,,2187,1164,2187,1023,1022,8,1014,426,588
70106,Voždovac,50,,2191,1189,2191,1002,1002,15,987,388,599
70106,Voždovac,51,,2463,1279,2463,1184,1184,18,1166,481,685
70106,Voždovac,52,,1563,736,1563,827,826,7,819,307,512
70106,Voždovac,53,,2203,1008,2203,1195,1195,19,1176,387,789
70106,Voždovac,54,,1960,1011,1961,949,949,10,939,367,572
70106,Voždovac,55,,2298,1149,2294,1149,1149,21,1128,481,647
70106,Voždovac,56,,2458,1301,2458,1157,1157,17,1140,460,680
70106,Voždovac,57,,1683,854,1683,829,829,12,817,394,423
70106,Voždovac,58,,1536,881,1536,655,654,4,650,324,326
70106,Voždovac,59,,1398,661,1398,737,736,12,724,301,423
70106,Voždovac,60,,1900,933,1900,967,967,10,957,411,546
70106,Voždovac,61,,1819,990,1819,829,829,6,823,499,324
70106,Voždovac,62,,2075,1092,2075,983,983,5,978,504,474
70106,Voždovac,63,,2348,1157,2348,1191,1191,14,1177,576,601
70106,Voždovac,64,,1465,769,1465,696,696,8,688,375,313
70106,Voždovac,65,,1818,955,1818,863,863,15,848,483,365
70106,Voždovac,66,,1515,717,1515,798,798,6,792,377,415
70106,Voždovac,67,,2143,1228,2143,915,915,16,899,520,379
70106,Voždovac,68,,1670,931,1670,739,738,10,728,361,367
70106,Voždovac,69,,1409,841,1411,568,568,10,558,309,249
70106,Voždovac,70,,1240,772,1240,468,468,8,460,253,207
70106,Voždovac,71,,1625,982,1625,643,643,6,637,363,274
70106,Voždovac,72,,1189,638,1189,551,551,7,544,291,253
70106,Voždovac,73,,1585,929,1585,656,656,6,650,400,250
70106,Voždovac,74,,1050,593,1050,457,457,7,450,244,206
70106,Voždovac,75,,386,224,386,162,162,3,159,99,60
70106,Voždovac,76,,1482,686,1482,796,796,8,788,265,523
70106,Voždovac,77,,1752,907,1752,845,845,10,835,331,504
70106,Voždovac,78,,1633,749,1633,884,884,19,865,322,543
70106,Voždovac,79,,1364,619,1364,745,744,10,734,228,506
70106,Voždovac,80,,1151,634,1178,517,517,9,508,276,232
70106,Voždovac,81,,1226,674,1249,552,552,9,543,252,291
70114,Vračar,1,,904,459,904,445,445,5,440,81,359
70114,Vračar,2,,1079,505,1079,574,574,5,569,105,464
70114,Vračar,3,,1007,468,1007,539,539,11,528,102,426
70114,Vračar,4,,988,529,988,459,459,7,452,107,345
70114,Vračar,5,,1044,469,1044,575,575,7,568,122,446
70114,Vračar,6,,974,427,974,547,547,10,537,127,410
70114,Vračar,7,,1195,591,1195,604,604,11,593,120,473
70114,Vračar,8,,796,368,796,428,428,9,419,118,301
70114,Vračar,9,,734,338,734,396,396,5,391,82,309
70114,Vračar,10,,947,493,947,454,454,10,444,106,338
70114,Vračar,11,,862,396,862,466,466,2,464,123,341
70114,Vračar,12,,739,347,739,392,392,3,389,87,302
70114,Vračar,13,,1003,419,1003,584,584,21,563,140,423
70114,Vračar,14,,860,418,860,442,442,9,433,88,345
70114,Vračar,15,,930,431,930,499,499,11,488,109,379
70114,Vračar,16,,999,440,999,559,559,5,554,127,427
70114,Vračar,17,,1122,558,1122,564,564,8,556,104,452
70114,Vračar,18,,1082,512,1082,570,570,7,563,133,430
70114,Vračar,19,,938,427,938,511,511,7,504,113,391
70114,Vračar,20,,1274,626,1274,648,648,10,638,154,484
70114,Vračar,21,,852,425,852,427,427,4,423,109,314
70114,Vračar,22,,772,382,772,390,390,4,386,84,302
70114,Vračar,23,,1060,453,1060,607,607,9,598,125,473
70114,Vračar,24,,854,381,854,473,473,6,467,115,352
70114,Vračar,25,,1138,522,1138,616,616,5,611,131,480
70114,Vračar,26,,1160,547,1161,613,613,3,610,147,463
70114,Vračar,27,,1002,532,1002,470,470,9,461,121,340
70114,Vračar,28,,963,459,963,504,504,3,501,109,392
70114,Vračar,29,,1124,595,1124,529,529,3,526,121,405
70114,Vračar,30,,967,488,967,479,479,7,472,76,396
70114,Vračar,31,,1008,535,1008,473,473,6,467,140,327
70114,Vračar,32,,853,397,853,456,456,8,448,87,361
70114,Vračar,33,,804,386,804,418,418,3,415,106,309
70114,Vračar,34,,902,416,902,486,486,1,485,91,394
70114,Vračar,35,,1126,587,1126,539,539,7,532,106,426
70114,Vračar,36,,1274,645,1274,629,629,10,619,138,481
70114,Vračar,37,,790,336,790,454,454,7,447,115,332
70114,Vračar,38,,868,381,868,487,487,8,479,98,381
70114,Vračar,39,,949,464,949,485,485,10,475,100,375
70114,Vračar,40,,1141,650,1141,491,491,7,484,118,366
70114,Vračar,41,,1097,544,1097,553,553,10,543,152,391
70114,Vračar,42,,960,479,960,481,481,7,474,151,323
70114,Vračar,43,,1105,554,1105,551,551,3,548,156,392
70114,Vračar,44,,1364,695,1364,669,669,6,663,222,441
70114,Vračar,45,,1166,585,1166,581,581,7,574,150,424
70114,Vračar,46,,1104,583,1104,521,521,3,518,158,360
70114,Vračar,47,,1825,843,1825,982,982,14,968,237,731
70114,Vračar,48,,1395,688,1395,707,707,6,701,180,521
70114,Vračar,49,,1087,559,1087,528,528,7,521,133,388
70114,Vračar,50,,1060,480,1060,580,580,17,563,104,459
70114,Vračar,51,,917,444,917,473,473,5,468,121,347
70114,Vračar,52,,1019,470,1019,549,549,8,541,130,411
70114,Vračar,53,,926,491,926,435,435,7,428,101,327
70114,Vračar,54,,1050,527,1050,523,523,4,519,101,418
70114,Vračar,55,,1126,571,1126,555,555,7,548,134,414
70114,Vračar,56,,1021,485,1021,536,535,6,529,148,381
70114,Vračar,57,,1227,641,1227,586,586,5,581,127,454
70114,Vračar,58,,1094,570,1094,524,524,7,517,119,398
70114,Vračar,59,,886,406,886,480,480,8,472,102,370
70114,Vračar,60,,1579,778,1579,801,801,9,792,195,597
70122,Grocka,1,,1746,1194,1746,552,551,5,546,328,218
70122,Grocka,2,,1276,860,1276,416,416,3,413,241,172
70122,Grocka,3,,1701,852,1701,849,849,17,832,436,396
70122,Grocka,4,,1507,789,1507,718,718,10,708,369,339
70122,Grocka,5,,1395,657,1395,738,738,6,732,419,313
70122,Grocka,6,,834,490,835,344,344,1,343,172,171
70122,Grocka,7,,2301,1258,2301,1043,1043,6,1037,559,478
70122,Grocka,8,,2362,1474,2362,888,887,7,880,395,485
70122,Grocka,9,,1806,1007,1806,799,799,7,792,367,425
70122,Grocka,10,,1692,1026,1692,666,666,8,658,336,322
70122,Grocka,11,,1674,1060,1674,614,614,7,607,369,238
70122,Grocka,12,,1749,1026,1749,723,723,15,708,348,360
70122,Grocka,13,,1696,810,1696,886,886,11,875,488,387
70122,Grocka,14,,1823,977,1823,846,846,13,833,420,413
70122,Grocka,15,,1992,1017,1993,975,975,16,959,473,486
70122,Grocka,16,,1720,862,1720,858,858,13,845,468,377
70122,Grocka,17,,1306,918,1306,388,388,2,386,229,157
70122,Grocka,18,,291,139,291,152,152,2,150,95,55
70122,Grocka,19,,1808,1115,1808,693,692,8,684,385,299
70122,Grocka,20,,2114,1148,2114,966,966,8,958,579,379
70122,Grocka,21,,2476,1360,2476,1116,1115,9,1106,640,466
70122,Grocka,22,,2182,1198,2182,984,984,10,974,624,350
70122,Grocka,23,,1997,1091,1997,906,905,6,899,610,289
70122,Grocka,24,,2142,1171,2142,971,971,12,959,547,412
70122,Grocka,25,,2260,1216,2260,1044,1044,5,1039,582,457
70122,Grocka,26,,2076,1098,2076,978,978,4,974,623,351
70122,Grocka,27,,1807,970,1807,837,837,6,831,572,259
70122,Grocka,28,,944,563,944,381,381,4,377,246,131
70122,Grocka,29,,2144,1300,2144,844,844,3,841,511,330
70122,Grocka,30,,2442,1392,2442,1050,1050,12,1038,630,408
70122,Grocka,31,,2458,1533,2458,925,925,2,923,644,279
70122,Grocka,32,,1166,707,1166,459,459,7,452,266,186
70122,Grocka,33,,1815,1140,1815,675,675,8,667,362,305
70122,Grocka,34,,1268,774,1268,494,494,11,483,261,222
70122,Grocka,35,,1258,874,1258,384,384,8,376,203,173
70149,Zvezdara,1,,2019,973,2019,1046,1046,10,1036,265,771
70149,Zvezdara,2,,1933,877,1933,1056,1056,10,1046,276,770
70149,Zvezdara,3,,1540,732,1540,808,808,18,790,200,590
70149,Zvezdara,4,,1281,648,1281,633,632,11,621,170,451
70149,Zvezdara,5,,2211,1094,2211,1117,1117,13,1104,363,741
70149,Zvezdara,6,,1313,714,1313,599,598,3,595,200,395
70149,Zvezdara,7,,1120,566,1121,554,554,2,552,163,389
70149,Zvezdara,8,,2205,1139,2205,1066,1066,14,1052,287,765
70149,Zvezdara,9,,1803,1001,1805,802,802,7,795,278,517
70149,Zvezdara,10,,1136,626,1136,510,510,6,504,161,343
70149,Zvezdara,11,,1798,893,1798,905,905,12,893,344,549
70149,Zvezdara,12,,1511,774,1511,737,737,16,721,236,485
70149,Zvezdara,13,,1526,928,1526,598,598,5,593,254,339
70149,Zvezdara,14,,1160,688,1160,472,472,5,467,249,218
70149,Zvezdara,15,,1225,579,1225,646,646,11,635,182,453
70149,Zvezdara,16,,1393,800,1393,593,593,2,591,210,381
70149,Zvezdara,17,,2221,1093,2221,1128,1128,18,1110,333,777
70149,Zvezdara,18,,1605,756,1606,849,847,12,835,201,634
70149,Zvezdara,19,,1033,514,1034,519,519,3,516,140,376
70149,Zvezdara,20,,1939,950,1939,989,989,14,975,290,685
70149,Zvezdara,21,,1305,554,1305,751,751,4,747,161,586
70149,Zvezdara,22,,1616,774,1616,842,842,6,836,252,584
70149,Zvezdara,23,,2084,1022,2086,1062,1060,9,1051,252,799
70149,Zvezdara,24,,1688,803,1688,885,885,14,871,220,651
70149,Zvezdara,25,,1010,596,1010,414,414,3,411,163,248
70149,Zvezdara,26,,2311,1093,2311,1218,1218,13,1205,382,823
70149,Zvezdara,27,,2203,1083,2203,1120,1120,18,1102,343,759
70149,Zvezdara,28,,2009,1040,2009,969,969,14,955,338,617
70149,Zvezdara,29,,2117,1055,2117,1062,1062,5,1057,371,686
70149,Zvezdara,30,,1660,837,1660,823,823,16,807,250,557
70149,Zvezdara,31,,976,501,977,475,475,8,467,168,299
70149,Zvezdara,32,,1555,849,1555,706,705,5,700,289,411
70149,Zvezdara,33,,1907,1060,1907,847,847,13,834,221,613
70149,Zvezdara,34,,1644,809,1644,835,835,5,830,345,485
70149,Zvezdara,35,,1278,599,1278,679,679,6,673,242,431
70149,Zvezdara,36,,1543,823,1543,720,720,1,719,258,461
70149,Zvezdara,37,,1398,692,1398,706,706,9,697,362,335
70149,Zvezdara,38,,1468,800,1468,668,666,4,662,285,377
70149,Zvezdara,39,,2333,1119,2333,1214,1211,21,1190,356,834
70149,Zvezdara,40,,1913,895,1915,1018,1018,8,1010,361,649
70149,Zvezdara,41,,2361,1241,2361,1120,1120,10,1110,377,733
70149,Zvezdara,42,,1201,676,1203,525,525,1,524,268,256
70149,Zvezdara,43,,1828,1117,1828,711,711,10,701,425,276
70149,Zvezdara,44,,1808,1051,1808,757,757,3,754,418,336
70149,Zvezdara,45,,1545,883,1545,662,662,6,656,285,371
70149,Zvezdara,46,,2210,1107,2211,1103,1103,11,1092,585,507
70149,Zvezdara,47,,1726,893,1726,833,833,7,826,451,375
70149,Zvezdara,48,,1749,1003,1749,746,746,5,741,405,336
70149,Zvezdara,49,,1661,898,1661,763,763,8,755,441,314
70149,Zvezdara,50,,1527,758,1527,769,769,1,768,475,293
70149,Zvezdara,51,,1695,797,1695,898,897,10,887,273,614
70149,Zvezdara,52,,2102,964,2102,1138,1137,17,1120,337,783
70149,Zvezdara,53,,1904,917,1904,987,987,15,972,292,680
70149,Zvezdara,54,,2234,988,2234,1246,1246,21,1225,454,771
70149,Zvezdara,55,,2083,1117,2067,966,966,8,958,466,492
70149,Zvezdara,56,,2152,1112,2153,1040,1040,10,1030,386,644
70149,Zvezdara,57,,2273,1117,2273,1156,1155,22,1133,448,685
70149,Zvezdara,58,,1648,769,1648,879,879,9,870,311,559
70149,Zvezdara,59,,1650,781,1650,869,869,14,855,297,558
70149,Zvezdara,60,,2030,1015,2030,1015,1014,13,1001,359,642
70149,Zvezdara,61,,2255,1130,2255,1125,1125,9,1116,440,676
70149,Zvezdara,62,,1930,909,1930,1021,1020,9,1011,424,587
70149,Zvezdara,63,,2312,1160,2312,1152,1152,14,1138,403,735
70149,Zvezdara,64,,1310,692,1310,618,618,6,612,226,386
70149,Zvezdara,65,,1380,643,1380,737,737,15,722,236,486
70149,Zvezdara,66,,1431,701,1431,730,730,12,718,327,391
70149,Zvezdara,67,,1766,832,1766,934,934,9,925,285,640
70149,Zvezdara,68,,1785,899,1785,886,886,15,871,366,505
70149,Zvezdara,69,,1983,1013,1984,970,970,10,960,349,611
70149,Zvezdara,70,,2259,1295,2259,964,962,18,944,424,520
70149,Zvezdara,71,,1700,907,1700,793,792,7,785,305,480
70149,Zvezdara,72,,1350,842,1350,508,508,1,507,237,270
70149,Zvezdara,73,,1519,835,1519,684,684,7,677,356,321
70157,Zemun,1,,1092,550,1092,542,542,6,536,130,406
70157,Zemun,2,,1515,741,1515,774,774,12,762,214,548
70157,Zemun,3,,1304,598,1304,706,706,7,699,146,553
70157,Zemun,4,,1275,610,1275,665,664,20,644,185,459
70157,Zemun,5,,2160,981,2160,1179,1179,17,1162,403,759
70157,Zemun,6,,2115,948,2115,1167,1167,14,1153,407,746
70157,Zemun,7,,1531,753,1531,778,778,5,773,244,529
70157,Zemun,8,,1643,807,1643,836,836,13,823,239,584
70157,Zemun,9,,1285,630,1285,655,655,7,648,208,440
70157,Zemun,10,,1352,668,1352,684,682,12,670,238,432
70157,Zemun,11,,1131,518,1131,613,613,7,606,185,421
70157,Zemun,12,,1411,676,1411,735,735,13,722,264,458
70157,Zemun,13,,1916,978,1915,938,938,11,927,341,586
70157,Zemun,14,,1496,711,1496,785,785,9,776,266,510
70157,Zemun,15,,1086,519,1086,567,567,5,562,162,400
70157,Zemun,16,,1793,932,1793,861,861,15,846,296,550
70157,Zemun,17,,1438,734,1438,704,704,9,695,226,469
70157,Zemun,18,,1284,649,1284,635,635,8,627,234,393
70157,Zemun,19,,1189,578,1189,611,611,6,605,198,407
70157,Zemun,20,,2006,1100,1806,906,906,9,897,266,631
70157,Zemun,21,,1349,694,1349,655,655,7,648,258,390
70157,Zemun,22,,1515,735,1516,780,780,10,770,284,486
70157,Zemun,23,,1513,670,1513,843,843,6,837,306,531
70157,Zemun,24,,1460,685,1460,775,775,7,768,273,495
70157,Zemun,25,,1069,569,1069,500,500,5,495,209,286
70157,Zemun,26,,1130,553,1136,577,577,9,568,226,342
70157,Zemun,27,,1365,776,1363,589,589,4,585,276,309
70157,Zemun,28,,1421,758,1421,663,663,13,650,255,395
70157,Zemun,29,,1395,704,1393,691,691,15,676,244,432
70157,Zemun,30,,1414,640,1414,774,774,7,767,295,472
70157,Zemun,31,,1374,710,1374,664,664,10,654,292,362
70157,Zemun,32,,1558,818,1558,740,740,6,734,283,451
70157,Zemun,33,,1191,587,1191,604,604,5,599,267,332
70157,Zemun,34,,1018,511,1018,507,507,8,499,235,264
70157,Zemun,35,,1338,677,1338,661,661,5,656,274,382
70157,Zemun,36,,1750,871,1750,879,879,10,869,410,459
70157,Zemun,37,,1612,779,1612,833,832,9,823,310,513
70157,Zemun,38,,1181,495,1281,686,686,4,682,285,397
70157,Zemun,39,,1364,719,1364,645,645,13,632,324,308
70157,Zemun,40,,1454,732,1454,722,722,15,707,337,370
70157,Zemun,41,,1187,626,1191,561,561,8,553,388,165
70157,Zemun,42,,1733,832,1733,901,901,14,887,410,477
70157,Zemun,43,,1468,711,1468,757,757,14,743,359,384
70157,Zemun,44,,1502,723,1502,779,779,10,769,396,373
70157,Zemun,45,,1268,623,1268,645,645,15,630,330,300
70157,Zemun,46,,1767,1023,1767,744,744,8,736,472,264
70157,Zemun,47,,1870,1301,1870,569,569,5,564,368,196
70157,Zemun,48,,1880,1225,1880,655,655,6,649,414,235
70157,Zemun,49,,1351,660,1351,691,691,6,685,328,357
70157,Zemun,50,,1501,812,1501,689,689,7,682,280,402
70157,Zemun,51,,1685,772,1685,913,912,14,898,394,504
70157,Zemun,52,,2275,1216,2276,1059,1059,4,1055,602,453
70157,Zemun,53,,1509,737,1509,772,772,5,767,338,429
70157,Zemun,54,,2011,1354,2011,657,655,0,655,352,303
70157,Zemun,55,,1542,714,1542,828,828,12,816,315,501
70157,Zemun,56,,1065,490,1065,575,575,9,566,265,301
70157,Zemun,57,,1413,638,1414,775,775,12,763,304,459
70157,Zemun,58,,2052,1155,2052,897,897,4,893,488,405
70157,Zemun,59,,2002,1087,2002,915,915,10,905,480,425
70157,Zemun,60,,1173,554,1173,619,619,8,611,297,314
70157,Zemun,61,,1578,794,1578,784,784,14,770,314,456
70157,Zemun,62,,1308,620,1308,688,687,8,679,267,412
70157,Zemun,63,,1161,566,1161,595,595,4,591,255,336
70157,Zemun,64,,1440,641,1440,799,797,17,780,308,472
70157,Zemun,65,,1406,703,1406,703,703,14,689,308,381
70157,Zemun,66,,1584,764,1584,820,819,13,806,388,418
70157,Zemun,67,,183,55,183,128,128,2,126,78,48
70157,Zemun,68,,2239,1401,2239,838,838,10,828,588,240
70157,Zemun,69,,1466,689,1466,777,777,10,767,480,287
70157,Zemun,70,,1443,742,1443,701,701,5,696,367,329
70157,Zemun,71,,1180,541,1180,639,639,6,633,323,310
70157,Zemun,72,,1289,664,1289,625,625,6,619,312,307
70157,Zemun,73,,1434,748,1434,686,686,6,680,340,340
70157,Zemun,74,,1081,571,1082,510,509,5,504,260,244
70157,Zemun,75,,1130,558,1130,572,572,6,566,293,273
70157,Zemun,76,,890,410,890,480,480,11,469,305,164
70157,Zemun,77,,1653,881,1653,772,772,13,759,538,221
70157,Zemun,78,,1590,855,1590,735,735,8,727,514,213
70157,Zemun,79,,1599,826,1599,773,773,8,765,522,243
70157,Zemun,80,,2144,1066,2144,1078,1078,6,1072,784,288
70157,Zemun,81,,1681,816,1681,865,865,5,860,523,337
70157,Zemun,82,,1752,833,1752,919,918,16,902,583,319
70157,Zemun,83,,1758,891,1758,867,867,6,861,541,320
70157,Zemun,84,,1718,846,1718,872,872,7,865,530,335
70157,Zemun,85,,1512,834,1512,678,677,7,670,371,299
70157,Zemun,86,,1621,781,1621,840,840,14,826,403,423
70157,Zemun,87,,1477,721,1477,756,756,11,745,354,391
70157,Zemun,88,,1423,733,1423,690,690,9,681,330,351
70157,Zemun,89,,1478,778,1478,700,700,12,688,342,346
70157,Zemun,90,,1733,859,1733,874,872,18,854,373,481
70157,Zemun,91,,2450,1269,2450,1181,1181,7,1174,912,262
70157,Zemun,92,,2288,1100,2288,1188,1188,8,1180,821,359
70157,Zemun,93,,1410,696,1410,714,714,11,703,448,255
70157,Zemun,94,,1214,639,1214,575,575,10,565,331,234
70157,Zemun,95,,1346,684,1346,662,662,7,655,434,221
70157,Zemun,96,,1395,799,1378,596,595,3,592,380,212
70157,Zemun,97,,1212,602,1212,610,609,8,601,385,216
70157,Zemun,98,,1356,762,1356,594,594,7,587,346,241
70157,Zemun,99,,1829,965,1829,864,864,15,849,524,325
70157,Zemun,100,,1422,683,1422,739,739,10,729,395,334
70157,Zemun,101,,1632,848,1632,784,784,10,774,455,319
70157,Zemun,102,,1907,904,1907,1003,1003,11,992,595,397
70157,Zemun,103,,1583,843,1565,740,740,6,734,427,307
70157,Zemun,104,,1513,784,1513,729,729,7,722,402,320
70157,Zemun,105,,1596,814,1596,782,782,4,778,502,276
70157,Zemun,106,,988,500,988,488,488,3,485,346,139
70157,Zemun,107,,1023,563,1023,460,460,6,454,310,144
70157,Zemun,108,,1754,966,1654,788,787,20,767,467,300
70157,Zemun,109,,1559,803,1559,756,756,5,751,458,293
70157,Zemun,110,,1645,870,1645,775,775,10,765,442,323
70157,Zemun,111,,1844,943,1844,901,899,22,877,530,347
70157,Zemun,112,,710,366,710,344,344,1,343,193,150
70157,Zemun,113,,843,471,846,372,371,4,367,214,153
70157,Zemun,114,,1105,504,1105,601,601,8,593,340,253
70165,Lazarevac,1,,691,289,692,402,402,7,395,149,246
70165,Lazarevac,2,,694,298,694,396,396,3,393,149,244
70165,Lazarevac,3,,729,318,729,411,411,8,403,157,246
70165,Lazarevac,4,,624,241,624,383,383,6,377,142,235
70165,Lazarevac,5,,1049,503,1049,546,546,7,539,225,314
70165,Lazarevac,6,,1471,660,1471,811,810,12,798,272,526
70165,Lazarevac,7,,867,352,867,515,514,14,500,187,313
70165,Lazarevac,8,,780,312,780,468,468,4,464,168,296
70165,Lazarevac,9,,873,421,873,452,452,6,446,182,264
70165,Lazarevac,10,,745,353,745,392,392,6,386,108,278
70165,Lazarevac,11,,1181,550,1181,631,631,13,618,256,362
70165,Lazarevac,12,,1320,738,1320,582,582,6,576,236,340
70165,Lazarevac,13,,1724,826,1729,898,898,5,893,372,521
70165,Lazarevac,14,,1111,548,1111,563,563,9,554,204,350
70165,Lazarevac,15,,1151,607,1151,544,544,6,538,198,340
70165,Lazarevac,16,,973,476,973,497,497,9,488,186,302
70165,Lazarevac,17,,890,475,890,415,415,2,413,212,201
70165,Lazarevac,18,,1121,577,1121,544,544,7,537,257,280
70165,Lazarevac,19,,1240,639,1240,601,601,11,590,284,306
70165,Lazarevac,20,,1463,720,1464,743,742,4,738,258,480
70165,Lazarevac,21,,848,477,848,371,370,5,365,212,153
70165,Lazarevac,22,,890,483,893,407,407,3,404,240,164
70165,Lazarevac,23,,1029,565,1029,464,464,10,454,251,203
70165,Lazarevac,24,,1025,601,1025,424,424,6,418,204,214
70165,Lazarevac,25,,884,418,884,466,466,11,455,256,199
70165,Lazarevac,26,,816,403,816,413,413,7,406,204,202
70165,Lazarevac,27,,868,407,868,461,461,15,446,244,202
70165,Lazarevac,28,,1302,752,1302,550,550,7,543,296,247
70165,Lazarevac,29,,1119,654,1119,465,465,6,459,199,260
70165,Lazarevac,30,,811,429,811,382,382,7,375,197,178
70165,Lazarevac,31,,939,561,939,378,378,6,372,184,188
70165,Lazarevac,32,,676,299,676,377,377,4,373,182,191
70165,Lazarevac,33,,826,323,826,503,503,11,492,232,260
70165,Lazarevac,34,,280,88,280,192,192,10,182,101,81
70165,Lazarevac,35,,707,386,708,321,321,3,318,185,133
70165,Lazarevac,36,,657,380,657,277,277,3,274,158,116
70165,Lazarevac,37,,573,237,573,336,336,10,326,163,163
70165,Lazarevac,38,,748,410,748,338,338,4,334,179,155
70165,Lazarevac,39,,785,349,785,436,436,3,433,186,247
70165,Lazarevac,40,,435,184,435,251,251,6,245,119,126
70165,Lazarevac,41,,211,76,211,135,135,0,135,47,88
70165,Lazarevac,42,,689,358,689,331,331,5,326,177,149
70165,Lazarevac,43,,744,343,744,401,401,8,393,204,189
70165,Lazarevac,44,,1014,532,1014,482,482,10,472,191,281
70165,Lazarevac,45,,479,227,479,252,252,2,250,106,144
70165,Lazarevac,46,,557,322,557,235,235,2,233,123,110
70165,Lazarevac,47,,623,322,623,301,301,6,295,154,141
70165,Lazarevac,48,,644,290,644,354,354,3,351,173,178
70165,Lazarevac,49,,775,459,775,316,316,6,310,166,144
70165,Lazarevac,50,,1069,575,1069,494,494,5,489,247,242
70165,Lazarevac,51,,620,344,620,276,276,2,274,127,147
70165,Lazarevac,52,,416,151,416,265,265,4,261,97,164
70165,Lazarevac,53,,470,237,470,233,233,3,230,99,131
70165,Lazarevac,54,,556,288,556,268,268,9,259,148,111
70165,Lazarevac,55,,385,208,385,177,177,5,172,94,78
70165,Lazarevac,56,,687,341,687,346,346,14,332,165,167
70165,Lazarevac,57,,281,109,281,172,172,2,170,82,88
70165,Lazarevac,58,,342,167,342,175,175,3,172,86,86
70165,Lazarevac,59,,425,255,425,170,170,3,167,68,99
70165,Lazarevac,60,,465,315,460,150,150,3,147,75,72
70165,Lazarevac,61,,283,148,283,135,135,6,129,80,49
70165,Lazarevac,62,,248,124,248,124,124,1,123,78,45
70165,Lazarevac,63,,106,55,106,51,51,3,48,33,15
70165,Lazarevac,64,,101,51,101,50,50,2,48,32,16
70173,Mladenovac,1,,948,504,948,444,444,4,440,201,239
70173,Mladenovac,2,,936,451,936,485,485,9,476,192,284
70173,Mladenovac,3,,832,396,832,436,436,7,429,175,254
70173,Mladenovac,4,,762,364,763,398,398,10,388,144,244
70173,Mladenovac,5,,826,358,826,468,468,17,451,159,292
70173,Mladenovac,6,,925,483,925,442,442,7,435,259,176
70173,Mladenovac,7,,929,456,929,473,473,6,467,255,212
70173,Mladenovac,8,,919,502,919,417,417,6,411,215,196
70173,Mladenovac,9,,817,400,817,417,417,8,409,185,224
70173,Mladenovac,10,,720,388,720,332,332,5,327,181,146
70173,Mladenovac,11,,845,454,847,391,391,5,386,220,166
70173,Mladenovac,12,,988,534,988,454,454,8,446,186,260
70173,Mladenovac,13,,988,439,988,549,549,15,534,211,323
70173,Mladenovac,14,,862,457,863,405,405,4,401,151,250
70173,Mladenovac,15,,1081,506,1081,575,575,11,564,258,306
70173,Mladenovac,16,,933,418,933,515,515,5,510,240,270
70173,Mladenovac,17,,832,331,932,501,501,12,489,229,260
70173,Mladenovac,18,,931,377,931,554,554,16,538,230,308
70173,Mladenovac,19,,813,404,813,409,409,8,401,181,220
70173,Mladenovac,20,,910,452,910,458,458,4,454,190,264
70173,Mladenovac,21,,892,429,892,463,463,6,457,195,262
70173,Mladenovac,22,,852,514,865,338,338,4,334,183,151
70173,Mladenovac,23,,972,513,972,459,459,9,450,248,202
70173,Mladenovac,24,,1227,588,1227,639,639,12,627,343,284
70173,Mladenovac,25,,893,500,893,393,393,10,383,185,198
70173,Mladenovac,26,,806,463,806,343,343,4,339,192,147
70173,Mladenovac,27,,1294,658,1294,636,636,3,633,408,225
70173,Mladenovac,28,,1098,588,1098,510,510,3,507,317,190
70173,Mladenovac,29,,1213,701,1213,512,512,1,511,352,159
70173,Mladenovac,30,,727,424,727,303,303,4,299,188,111
70173,Mladenovac,31,,828,494,828,334,334,3,331,164,167
70173,Mladenovac,32,,871,504,871,367,367,5,362,180,182
70173,Mladenovac,33,,697,461,697,236,236,3,233,140,93
70173,Mladenovac,34,,599,288,599,311,311,5,306,187,119
70173,Mladenovac,35,,144,107,144,37,37,0,37,26,11
70173,Mladenovac,36,,434,261,434,173,173,3,170,129,41
70173,Mladenovac,37,,298,163,298,135,135,3,132,76,56
70173,Mladenovac,38,,627,335,627,292,292,3,289,150,139
70173,Mladenovac,39,,628,359,628,269,269,4,265,146,119
70173,Mladenovac,40,,602,418,602,184,184,1,183,125,58
70173,Mladenovac,41,,575,368,577,207,207,2,205,89,116
70173,Mladenovac,42,,540,336,540,204,204,2,202,100,102
70173,Mladenovac,43,,736,419,736,317,317,6,311,191,120
70173,Mladenovac,44,,777,394,777,383,383,5,378,237,141
70173,Mladenovac,45,,961,549,961,412,412,6,406,228,178
70173,Mladenovac,46,,1095,542,1095,553,553,9,544,320,224
70173,Mladenovac,47,,815,538,815,277,277,7,270,168,102
70173,Mladenovac,48,,605,406,605,199,199,0,199,114,85
70173,Mladenovac,49,,898,531,898,367,367,10,357,232,125
70173,Mladenovac,50,,404,206,404,198,198,7,191,152,39
70173,Mladenovac,51,,206,87,206,119,119,2,117,71,46
70173,Mladenovac,52,,679,398,679,281,281,5,276,172,104
70173,Mladenovac,53,,674,367,674,307,307,8,299,203,96
70173,Mladenovac,54,,277,148,277,129,129,0,129,89,40
70173,Mladenovac,55,,452,256,452,196,196,0,196,125,71
70173,Mladenovac,56,,700,456,700,244,244,4,240,127,113
70173,Mladenovac,57,,638,369,638,269,269,5,264,164,100
70173,Mladenovac,58,,801,462,801,339,339,5,334,232,102
70173,Mladenovac,59,,692,476,692,216,216,1,215,142,73
70173,Mladenovac,60,,300,185,300,115,115,1,114,45,69
70181,Novi Beograd,1,,2326,1399,2326,927,927,9,918,470,448
70181,Novi Beograd,2,,1576,706,1577,870,870,15,855,247,608
70181,Novi Beograd,3,,1595,753,1595,842,842,12,830,314,516
70181,Novi Beograd,4,,1432,685,1432,747,747,13,734,249,485
70181,Novi Beograd,5,,1638,824,1638,814,814,17,797,276,521
70181,Novi Beograd,6,,1932,915,1932,1017,1017,12,1005,391,614
70181,Novi Beograd,7,,1478,686,1478,792,792,9,783,327,456
70181,Novi Beograd,8,,1400,642,1400,758,758,13,745,249,496
70181,Novi Beograd,9,,1469,672,1469,797,797,20,777,256,521
70181,Novi Beograd,10,,1232,606,1232,626,626,8,618,253,365
70181,Novi Beograd,11,,1629,750,1629,879,879,2,877,358,519
70181,Novi Beograd,12,,1486,662,1486,824,824,12,812,305,507
70181,Novi Beograd,13,,1187,533,1187,654,654,11,643,227,416
70181,Novi Beograd,14,,1398,645,1398,753,753,12,741,280,461
70181,Novi Beograd,15,,1860,805,1860,1055,1055,14,1041,382,659
70181,Novi Beograd,16,,1235,563,1235,672,672,22,650,211,439
70181,Novi Beograd,17,,1547,642,1547,905,905,17,888,393,495
70181,Novi Beograd,18,,1211,568,1211,643,642,7,635,169,466
70181,Novi Beograd,19,,1367,636,1367,731,731,18,713,213,500
70181,Novi Beograd,20,,1193,531,1193,662,662,11,651,162,489
70181,Novi Beograd,21,,1667,712,1667,955,955,16,939,323,616
70181,Novi Beograd,22,,1530,687,1530,843,843,12,831,285,546
70181,Novi Beograd,23,,1408,670,1408,738,738,12,726,265,461
70181,Novi Beograd,24,,1473,685,1473,788,788,14,774,247,527
70181,Novi Beograd,25,,1535,716,1535,819,819,18,801,259,542
70181,Novi Beograd,26,,1946,940,1946,1006,1006,14,992,253,739
70181,Novi Beograd,27,,1418,623,1419,795,793,15,778,225,553
70181,Novi Beograd,28,,1713,840,1713,873,873,18,855,254,601
70181,Novi Beograd,29,,1436,732,1436,704,704,15,689,220,469
70181,Novi Beograd,30,,1023,497,1023,526,526,6,520,153,367
70181,Novi Beograd,31,,916,429,916,487,487,9,478,198,280
70181,Novi Beograd,32,,860,357,860,503,503,4,499,156,343
70181,Novi Beograd,33,,1318,631,1318,687,687,10,677,235,442
70181,Novi Beograd,34,,948,427,948,521,521,6,515,206,309
70181,Novi Beograd,35,,1542,691,1542,851,851,11,840,307,533
70181,Novi Beograd,36,,1783,778,1784,1005,1004,14,990,373,617
70181,Novi Beograd,37,,1134,516,1134,618,618,15,603,189,414
70181,Novi Beograd,38,,890,379,890,511,511,6,505,156,349
70181,Novi Beograd,39,,1187,578,1187,609,609,13,596,251,345
70181,Novi Beograd,40,,1855,923,1755,932,932,15,917,332,585
70181,Novi Beograd,41,,1796,814,1796,982,982,6,976,322,654
70181,Novi Beograd,42,,1650,692,1650,958,958,22,936,289,647
70181,Novi Beograd,43,,1592,758,1592,834,834,7,827,295,532
70181,Novi Beograd,44,,1257,576,1257,681,681,10,671,183,488
70181,Novi Beograd,45,,1617,798,1617,819,819,8,811,305,506
70181,Novi Beograd,46,,1668,839,1668,829,829,11,818,283,535
70181,Novi Beograd,47,,1829,927,1829,902,902,10,892,293,599
70181,Novi Beograd,48,,1773,953,1773,820,820,17,803,285,518
70181,Novi Beograd,49,,1410,759,1410,651,651,3,648,256,392
70181,Novi Beograd,50,,1363,663,1364,700,700,9,691,228,463
70181,Novi Beograd,51,,1093,550,1093,543,543,16,527,193,334
70181,Novi Beograd,52,,1151,502,1151,649,649,11,638,184,454
70181,Novi Beograd,53,,1552,649,1552,903,903,19,884,237,647
70181,Novi Beograd,54,,1785,872,1785,913,912,11,901,320,581
70181,Novi Beograd,55,,1683,832,1683,851,851,16,835,313,522
70181,Novi Beograd,56,,1666,795,1666,871,871,15,856,272,584
70181,Novi Beograd,57,,1094,548,1094,546,546,5,541,158,383
70181,Novi Beograd,58,,811,391,811,420,420,5,415,113,302
70181,Novi Beograd,59,,1328,650,1330,678,678,11,667,207,460
70181,Novi Beograd,60,,1585,817,1585,768,768,9,759,281,478
70181,Novi Beograd,61,,1392,682,1392,710,710,9,701,233,468
70181,Novi Beograd,62,,1777,849,1777,928,928,11,917,331,586
70181,Novi Beograd,63,,1600,797,1600,803,803,13,790,307,483
70181,Novi Beograd,64,,1225,626,1225,599,599,16,583,206,377
70181,Novi Beograd,65,,1336,690,1336,646,646,10,636,249,387
70181,Novi Beograd,66,,1200,583,1200,617,617,10,607,277,330
70181,Novi Beograd,67,,1534,775,1533,759,759,17,742,284,458
70181,Novi Beograd,68,,1362,667,1362,695,695,6,689,282,407
70181,Novi Beograd,69,,1670,744,1670,926,926,9,917,327,590
70181,Novi Beograd,70,,1837,945,1837,892,892,12,880,256,624
70181,Novi Beograd,71,,1500,697,1500,803,803,13,790,193,597
70181,Novi Beograd,72,,1523,736,1523,787,787,13,774,267,507
70181,Novi Beograd,73,,1724,806,1724,918,918,18,900,210,690
70181,Novi Beograd,74,,1647,819,1647,828,828,14,814,286,528
70181,Novi Beograd,75,,1745,843,1732,902,902,22,880,313,567
70181,Novi Beograd,76,,1532,750,1532,782,782,14,768,240,528
70181,Novi Beograd,77,,1770,818,1770,952,952,15,937,268,669
70181,Novi Beograd,78,,1640,793,1640,847,847,15,832,288,544
70181,Novi Beograd,79,,1854,923,1854,931,931,16,915,310,605
70181,Novi Beograd,80,,1230,580,1230,650,650,12,638,198,440
70181,Novi Beograd,81,,1253,553,1253,700,700,16,684,201,483
70181,Novi Beograd,82,,1636,733,1636,903,903,12,891,263,628
70181,Novi Beograd,83,,1869,897,1869,972,972,12,960,251,709
70181,Novi Beograd,84,,1388,687,1388,701,700,10,690,207,483
70181,Novi Beograd,85,,1591,766,1591,825,825,18,807,274,533
70181,Novi Beograd,86,,1507,652,1507,855,855,13,842,248,594
70181,Novi Beograd,87,,1662,752,1662,910,910,17,893,216,677
70181,Novi Beograd,88,,1365,663,1365,702,702,8,694,199,495
70181,Novi Beograd,89,,1397,678,1397,719,719,7,712,245,467
70181,Novi Beograd,90,,1636,847,1636,789,789,14,775,315,460
70181,Novi Beograd,91,,2318,1024,2318,1294,1292,22,1270,573,697
70181,Novi Beograd,92,,2056,995,2056,1061,1060,5,1055,434,621
70181,Novi Beograd,93,,2280,1057,2281,1223,1223,15,1208,415,793
70181,Novi Beograd,94,,1385,635,1385,750,750,6,744,304,440
70181,Novi Beograd,95,,1610,708,1610,902,902,17,885,354,531
70181,Novi Beograd,96,,1443,629,1443,814,814,10,804,323,481
70181,Novi Beograd,97,,1370,685,1370,685,685,14,671,272,399
70181,Novi Beograd,98,,1870,921,1870,949,948,18,930,415,515
70181,Novi Beograd,99,,1528,729,1528,799,798,5,793,304,489
70181,Novi Beograd,100,,1397,708,1397,689,689,8,681,269,412
70181,Novi Beograd,101,,1915,905,1915,1010,1010,17,993,450,543
70181,Novi Beograd,102,,1589,717,1589,872,872,9,863,339,524
70181,Novi Beograd,103,,1315,594,1315,721,721,11,710,249,461
70181,Novi Beograd,104,,1552,759,1552,793,793,11,782,300,482
70181,Novi Beograd,105,,1813,825,1813,988,987,15,972,359,613
70181,Novi Beograd,106,,1601,674,1601,927,927,12,915,324,591
70181,Novi Beograd,107,,1753,768,1854,985,985,10,975,377,598
70181,Novi Beograd,108,,1918,961,1919,957,957,17,940,374,566
70181,Novi Beograd,109,,1754,822,1754,932,932,11,921,364,557
70181,Novi Beograd,110,,2104,1095,2124,1009,1008,15,993,392,601
70181,Novi Beograd,111,,1554,715,1554,839,839,21,818,283,535
70181,Novi Beograd,112,,1299,673,1299,626,626,11,615,204,411
70181,Novi Beograd,113,,1649,801,1649,848,848,5,843,282,561
70181,Novi Beograd,114,,1487,730,1487,757,757,8,749,251,498
70181,Novi Beograd,115,,1786,891,1786,895,895,5,890,378,512
70181,Novi Beograd,116,,1903,874,1903,1029,1029,7,1022,345,677
70181,Novi Beograd,117,,1874,797,1874,1077,1077,19,1058,358,700
70181,Novi Beograd,118,,1874,884,1874,990,989,10,979,338,641
70181,Novi Beograd,119,,1737,787,1737,950,949,13,936,315,621
70181,Novi Beograd,120,,1350,763,1350,587,587,9,578,292,286
70181,Novi Beograd,121,,1536,706,1536,830,830,12,818,257,561
70181,Novi Beograd,122,,1904,1010,1904,894,894,16,878,413,465
70181,Novi Beograd,123,,1814,891,1814,923,923,14,909,363,546
70181,Novi Beograd,124,,1236,602,1236,634,634,7,627,264,363
70181,Novi Beograd,125,,1506,708,1506,798,798,6,792,372,420
70181,Novi Beograd,126,,2046,948,2047,1098,1098,9,1089,468,621
70181,Novi Beograd,127,,1748,734,1748,1014,1014,11,1003,461,542
70181,Novi Beograd,128,,1631,721,1631,910,910,15,895,377,518
70181,Novi Beograd,129,,1854,981,1854,873,873,14,859,367,492
70181,Novi Beograd,130,,1215,781,1215,434,434,0,434,227,207
70181,Novi Beograd,131,,1226,665,1226,561,561,15,546,280,266
70181,Novi Beograd,132,,1634,946,1634,688,688,13,675,386,289
70181,Novi Beograd,133,,1591,989,1591,602,602,6,596,287,309
70181,Novi Beograd,134,,1689,933,1689,756,756,10,746,432,314
70190,Obrenovac,1,,858,452,858,406,406,3,403,172,231
70190,Obrenovac,2,,1009,664,1009,345,345,15,330,191,139
70190,Obrenovac,3,,1088,490,1088,598,598,8,590,233,357
70190,Obrenovac,4,,1094,546,1094,548,548,6,542,261,281
70190,Obrenovac,5,,965,502,965,463,463,6,457,168,289
70190,Obrenovac,6,,1079,506,1079,573,573,15,558,235,323
70190,Obrenovac,7,,1069,568,1069,501,501,6,495,191,304
70190,Obrenovac,8,,891,393,891,498,498,8,490,189,301
70190,Obrenovac,9,,1614,777,1614,837,837,8,829,344,485
70190,Obrenovac,10,,991,488,991,503,503,9,494,198,296
70190,Obrenovac,11,,1010,469,1010,541,541,10,531,215,316
70190,Obrenovac,12,,1403,612,1403,791,791,19,772,272,500
70190,Obrenovac,13,,1417,645,1418,772,772,17,755,303,452
70190,Obrenovac,14,,976,489,976,487,487,7,480,199,281
70190,Obrenovac,15,,1621,912,1621,709,709,12,697,280,417
70190,Obrenovac,16,,912,459,912,453,453,9,444,225,219
70190,Obrenovac,17,,1964,937,1964,1027,1027,17,1010,493,517
70190,Obrenovac,18,,1042,526,1042,516,516,4,512,226,286
70190,Obrenovac,19,,1532,678,1533,854,854,18,836,318,518
70190,Obrenovac,20,,1494,825,1494,669,669,6,663,337,326
70190,Obrenovac,21,,1288,645,1288,643,643,20,623,301,322
70190,Obrenovac,22,,1061,486,1061,575,575,12,563,287,276
70190,Obrenovac,23,,879,480,879,399,399,7,392,222,170
70190,Obrenovac,24,,1005,592,1005,413,413,6,407,232,175
70190,Obrenovac,25,,1135,609,1135,526,526,6,520,303,217
70190,Obrenovac,26,,1170,607,1170,563,563,3,560,349,211
70190,Obrenovac,27,,1152,625,1152,527,527,7,520,291,229
70190,Obrenovac,28,,1588,850,1588,738,738,5,733,440,293
70190,Obrenovac,29,,1638,780,1638,858,858,10,848,401,447
70190,Obrenovac,30,,1347,711,1347,636,636,10,626,345,281
70190,Obrenovac,31,,1267,647,1267,620,620,6,614,405,209
70190,Obrenovac,32,,1267,639,1267,628,628,9,619,328,291
70190,Obrenovac,33,,1341,763,1341,578,578,11,567,324,243
70190,Obrenovac,34,,945,586,945,359,358,7,351,216,135
70190,Obrenovac,35,,1201,739,1201,462,462,10,452,240,212
70190,Obrenovac,36,,450,275,450,175,175,1,174,91,83
70190,Obrenovac,37,,777,388,777,389,389,4,385,191,194
70190,Obrenovac,38,,360,207,360,153,153,2,151,72,79
70190,Obrenovac,39,,1760,997,1760,763,763,11,752,386,366
70190,Obrenovac,40,,569,317,569,252,252,2,250,129,121
70190,Obrenovac,41,,632,288,632,344,344,1,343,144,199
70190,Obrenovac,42,,1161,782,1165,379,379,6,373,217,156
70190,Obrenovac,43,,680,408,680,272,272,3,269,145,124
70190,Obrenovac,44,,548,285,548,263,263,4,259,153,106
70190,Obrenovac,45,,912,623,912,289,289,4,285,191,94
70190,Obrenovac,46,,666,398,666,268,268,3,265,158,107
70190,Obrenovac,47,,736,390,736,346,346,2,344,225,119
70190,Obrenovac,48,,784,403,784,381,381,9,372,191,181
70190,Obrenovac,49,,927,479,927,448,448,3,445,264,181
70190,Obrenovac,50,,1206,750,1206,456,456,5,451,250,201
70190,Obrenovac,51,,1504,802,1504,702,702,11,691,363,328
70190,Obrenovac,52,,1014,544,1014,470,469,6,463,212,251
70190,Obrenovac,53,,1431,806,1431,625,625,10,615,382,233
70190,Obrenovac,54,,1147,643,1147,504,504,4,500,309,191
70190,Obrenovac,55,,1443,842,1443,601,600,9,591,306,285
70203,Palilula,1,,1269,583,1269,686,686,10,676,164,512
70203,Palilula,2,,865,422,865,443,443,5,438,120,318
70203,Palilula,3,,929,415,929,514,514,5,509,104,405
70203,Palilula,4,,766,356,766,410,410,8,402,92,310
70203,Palilula,5,,882,450,882,432,432,9,423,138,285
70203,Palilula,6,,1497,742,1497,755,754,6,748,225,523
70203,Palilula,7,,1070,564,1070,506,506,5,501,139,362
70203,Palilula,8,,1335,619,1335,716,716,6,710,164,546
70203,Palilula,9,,790,378,790,412,412,9,403,78,325
70203,Palilula,10,,968,457,968,511,511,7,504,108,396
70203,Palilula,11,,1073,528,1072,545,545,8,537,136,401
70203,Palilula,12,,1036,435,1036,601,601,14,587,158,429
70203,Palilula,13,,1186,567,1186,619,619,14,605,168,437
70203,Palilula,14,,948,456,948,492,492,9,483,133,350
70203,Palilula,15,,903,385,903,518,518,9,509,127,382
70203,Palilula,16,,1089,549,1089,540,540,10,530,128,402
70203,Palilula,17,,1044,468,1044,576,576,4,572,168,404
70203,Palilula,18,,891,401,892,490,490,10,480,135,345
70203,Palilula,19,,1175,550,1175,625,625,12,613,154,459
70203,Palilula,20,,1199,583,1199,616,616,9,607,149,458
70203,Palilula,21,,1074,520,1074,554,554,15,539,120,419
70203,Palilula,22,,1184,571,1184,613,613,10,603,139,464
70203,Palilula,23,,1086,507,1086,579,579,10,569,147,422
70203,Palilula,24,,1046,534,1046,512,512,5,507,157,350
70203,Palilula,25,,1041,497,1041,544,544,6,538,152,386
70203,Palilula,26,,1057,534,1057,523,523,4,519,162,357
70203,Palilula,27,,733,337,733,396,396,2,394,101,293
70203,Palilula,28,,1035,534,1035,501,501,3,498,161,337
70203,Palilula,29,,847,449,847,398,398,4,394,135,259
70203,Palilula,30,,1697,1127,1699,570,570,8,562,253,309
70203,Palilula,31,,1266,676,1266,590,590,9,581,201,380
70203,Palilula,32,,1025,523,1025,502,502,9,493,225,268
70203,Palilula,33,,926,518,926,408,408,1,407,103,304
70203,Palilula,34,,1050,532,1050,518,518,10,508,160,348
70203,Palilula,35,,1055,610,1055,445,445,4,441,149,292
70203,Palilula,36,,996,508,996,488,488,5,483,172,311
70203,Palilula,37,,1125,547,1125,578,578,5,573,196,377
70203,Palilula,38,,907,448,907,459,459,6,453,134,319
70203,Palilula,39,,1107,567,1107,540,540,5,535,174,361
70203,Palilula,40,,1024,507,1024,517,517,6,511,182,329
70203,Palilula,41,,1057,538,1057,519,519,7,512,183,329
70203,Palilula,42,,988,596,988,392,392,2,390,157,233
70203,Palilula,43,,913,518,913,395,395,1,394,167,227
70203,Palilula,44,,811,420,811,391,391,4,387,130,257
70203,Palilula,45,,973,444,973,529,529,5,524,165,359
70203,Palilula,46,,1210,594,1210,616,616,11,605,211,394
70203,Palilula,47,,881,449,881,432,432,3,429,151,278
70203,Palilula,48,,1162,632,1162,530,530,8,522,192,330
70203,Palilula,49,,1284,708,1284,576,576,12,564,200,364
70203,Palilula,50,,1147,568,1147,579,579,3,576,210,366
70203,Palilula,51,,1445,736,1445,709,708,4,704,324,380
70203,Palilula,52,,958,519,958,439,439,7,432,150,282
70203,Palilula,53,,1294,732,1294,562,562,3,559,254,305
70203,Palilula,54,,1177,642,1177,535,535,9,526,182,344
70203,Palilula,55,,1197,649,1197,548,548,12,536,153,383
70203,Palilula,56,,1034,542,1034,492,492,13,479,171,308
70203,Palilula,57,,1070,555,1070,515,515,9,506,191,315
70203,Palilula,58,,1002,573,1002,429,429,2,427,147,280
70203,Palilula,59,,1186,573,1186,613,613,8,605,186,419
70203,Palilula,60,,1723,945,1723,778,778,9,769,282,487
70203,Palilula,61,,1277,694,1277,583,583,4,579,223,356
70203,Palilula,62,,1112,621,1112,491,491,11,480,181,299
70203,Palilula,63,,1723,1164,1723,559,559,13,546,298,248
70203,Palilula,64,,2168,1239,2168,929,929,5,924,500,424
70203,Palilula,65,,1633,718,1633,915,915,15,900,295,605
70203,Palilula,66,,1098,469,1098,629,629,6,623,211,412
70203,Palilula,67,,1373,677,1373,696,696,9,687,248,439
70203,Palilula,68,,1219,709,1219,510,509,10,499,241,258
70203,Palilula,69,,983,505,983,478,478,3,475,203,272
70203,Palilula,70,,1379,739,1379,640,640,6,634,247,387
70203,Palilula,71,,1723,917,1723,806,806,7,799,458,341
70203,Palilula,72,,1342,808,1343,534,534,3,531,308,223
70203,Palilula,73,,1788,945,1788,843,843,10,833,448,385
70203,Palilula,74,,1004,503,1004,501,500,8,492,224,268
70203,Palilula,75,,1317,641,1317,676,676,3,673,347,326
70203,Palilula,76,,1459,804,1459,655,655,9,646,345,301
70203,Palilula,77,,535,246,535,289,289,1,288,170,118
70203,Palilula,78,,2157,1010,2157,1147,1146,11,1135,572,563
70203,Palilula,79,,1121,542,1121,579,579,8,571,374,197
70203,Palilula,80,,1553,771,1553,782,782,16,766,377,389
70203,Palilula,81,,2266,1363,2266,903,903,7,896,521,375
70203,Palilula,82,,1806,1091,1806,715,715,15,700,353,347
70203,Palilula,83,,1557,853,1557,704,704,17,687,343,344
70203,Palilula,84,,1353,751,1353,602,602,12,590,294,296
70203,Palilula,85,,1311,712,1311,599,599,8,591,335,256
70203,Palilula,86,,1642,890,1644,752,752,9,743,348,395
70203,Palilula,87,,1393,721,1393,672,672,19,653,343,310
70203,Palilula,88,,1426,760,1426,666,666,14,652,215,437
70203,Palilula,89,,1270,678,1270,592,592,8,584,224,360
70203,Palilula,90,,1373,669,1373,704,704,6,698,297,401
70203,Palilula,91,,1161,594,1161,567,567,4,563,332,231
70203,Palilula,92,,889,439,889,450,450,7,443,161,282
70203,Palilula,93,,877,487,878,390,390,6,384,230,154
70203,Palilula,94,,511,223,511,288,288,3,285,155,130
70203,Palilula,95,,656,310,656,346,346,3,343,242,101
70203,Palilula,96,,1511,861,1511,650,650,10,640,367,273
70203,Palilula,97,,1389,752,1389,637,637,3,634,350,284
70203,Palilula,98,,916,455,916,461,461,7,454,281,173
70203,Palilula,99,,1567,799,1567,768,768,8,760,419,341
70203,Palilula,100,,859,450,859,409,409,3,406,252,154
70203,Palilula,101,,1024,458,1024,566,566,4,562,330,232
70203,Palilula,102,,802,379,802,423,420,4,416,284,132
70203,Palilula,103,,619,427,619,192,192,0,192,90,102
70203,Palilula,104,,707,461,708,246,246,3,243,158,85
70203,Palilula,105,,762,533,762,229,229,0,229,125,104
70203,Palilula,106,,649,438,649,211,211,3,208,129,79
70203,Palilula,107,,1768,886,1830,882,882,6,876,356,520
70203,Palilula,108,,771,432,771,339,339,2,337,171,166
70203,Palilula,109,,1228,620,1228,608,608,5,603,260,343
70203,Palilula,110,,942,583,942,359,359,4,355,173,182
70203,Palilula,111,,2089,1186,2089,903,902,8,894,385,509
70203,Palilula,112,,1199,825,1198,374,374,6,368,207,161
70203,Palilula,113,,2053,1161,2053,892,892,7,885,428,457
70203,Palilula,114,,2187,1230,2187,957,957,6,951,532,419
70203,Palilula,115,,920,471,920,449,449,6,443,165,278
70203,Palilula,116,,1041,552,1041,489,489,11,478,201,277
70203,Palilula,117,,1352,726,1352,626,626,5,621,249,372
70203,Palilula,118,,1047,545,1047,502,502,7,495,168,327
70203,Palilula,119,,1187,607,1187,580,580,6,574,221,353
70203,Palilula,120,,1468,823,1468,645,645,7,638,329,309
70203,Palilula,121,,1706,1056,1708,650,650,14,636,370,266
70211,Rakovica,1,,1676,820,1676,856,855,16,839,314,525
70211,Rakovica,2,,1738,881,1738,857,857,5,852,289,563
70211,Rakovica,3,,1373,677,1373,696,696,6,690,211,479
70211,Rakovica,4,,1547,733,1547,814,814,17,797,287,510
70211,Rakovica,5,,1460,752,1460,708,706,12,694,246,448
70211,Rakovica,6,,1749,888,1749,861,861,13,848,333,515
70211,Rakovica,7,,1991,1060,1991,931,931,9,922,410,512
70211,Rakovica,8,,1640,857,1640,783,783,4,779,263,516
70211,Rakovica,9,,1324,660,1323,664,664,12,652,252,400
70211,Rakovica,10,,1770,946,1770,824,823,4,819,320,499
70211,Rakovica,11,,1841,953,1841,888,888,4,884,348,536
70211,Rakovica,12,,1967,1021,1967,946,946,13,933,358,575
70211,Rakovica,13,,1792,874,1792,918,917,12,905,360,545
70211,Rakovica,14,,1551,808,1551,743,743,11,732,275,457
70211,Rakovica,15,,1608,854,1608,754,754,13,741,286,455
70211,Rakovica,16,,2179,1163,2179,1016,1016,13,1003,331,672
70211,Rakovica,17,,1253,636,1253,617,617,7,610,212,398
70211,Rakovica,18,,1660,872,1660,788,786,12,774,299,475
70211,Rakovica,19,,1876,1009,1876,867,867,7,860,295,565
70211,Rakovica,20,,2000,980,2000,1020,1020,15,1005,364,641
70211,Rakovica,21,,1870,1039,1870,831,831,12,819,377,442
70211,Rakovica,22,,1866,937,1867,929,929,14,915,369,546
70211,Rakovica,23,,1928,1074,1928,854,854,4,850,317,533
70211,Rakovica,24,,1554,700,1554,854,854,19,835,286,549
70211,Rakovica,25,,1236,662,1236,574,574,4,570,186,384
70211,Rakovica,26,,1741,861,1741,880,880,13,867,295,572
70211,Rakovica,27,,1711,868,1711,843,843,10,833,317,516
70211,Rakovica,28,,1640,816,1640,824,824,7,817,297,520
70211,Rakovica,29,,2047,1038,2047,1009,1009,19,990,395,595
70211,Rakovica,30,,1844,930,1844,914,914,16,898,331,567
70211,Rakovica,31,,2066,989,2066,1077,1077,18,1059,494,565
70211,Rakovica,32,,1909,904,1909,1005,1005,18,987,346,641
70211,Rakovica,33,,1773,782,1773,991,991,15,976,341,635
70211,Rakovica,34,,1426,685,1438,741,741,10,731,299,432
70211,Rakovica,35,,690,374,690,316,316,11,305,170,135
70211,Rakovica,36,,1732,914,1732,818,818,3,815,373,442
70211,Rakovica,37,,2181,1084,2181,1097,1097,15,1082,363,719
70211,Rakovica,38,,1975,1100,1975,875,875,12,863,316,547
70211,Rakovica,39,,2076,1008,2076,1068,1068,16,1052,414,638
70211,Rakovica,40,,1685,880,1685,805,805,8,797,384,413
70211,Rakovica,41,,2238,1126,2238,1112,1111,21,1090,438,652
70211,Rakovica,42,,1205,628,1205,577,576,12,564,208,356
70211,Rakovica,43,,1543,750,1543,793,793,5,788,353,435
70211,Rakovica,44,,1580,737,1580,843,843,11,832,350,482
70211,Rakovica,45,,1712,901,1713,811,810,17,793,306,487
70211,Rakovica,46,,840,518,840,322,322,3,319,196,123
70211,Rakovica,47,,1970,1013,1970,957,957,9,948,422,526
70211,Rakovica,48,,2007,1026,2007,981,981,9,972,507,465
70211,Rakovica,49,,2395,1360,2395,1035,1035,8,1027,647,380
70211,Rakovica,50,,2423,1266,2423,1157,1157,12,1145,593,552
70211,Rakovica,51,,1990,1152,1990,838,838,8,830,553,277
70211,Rakovica,52,,2036,1220,2036,816,816,12,804,458,346
70211,Rakovica,53,,2008,1209,2008,799,799,11,788,404,384
70220,Savski Venac,1,,1277,691,1277,586,586,6,580,196,384
70220,Savski Venac,2,,997,497,1000,500,500,4,496,135,361
70220,Savski Venac,3,,1076,510,1076,566,566,7,559,139,420
70220,Savski Venac,4,,1159,589,1159,570,570,14,556,177,379
70220,Savski Venac,5,,1079,543,1079,536,536,5,531,157,374
70220,Savski Venac,6,,1062,536,1062,526,526,6,520,173,347
70220,Savski Venac,7,,967,491,967,476,476,8,468,160,308
70220,Savski Venac,8,,1092,517,1092,575,575,5,570,143,427
70220,Savski Venac,9,,1313,651,1313,662,662,14,648,211,437
70220,Savski Venac,10,,1291,616,1291,675,675,9,666,186,480
70220,Savski Venac,11,,1696,862,1696,834,834,16,818,311,507
70220,Savski Venac,12,,1043,552,1043,491,491,4,487,145,342
70220,Savski Venac,13,,1061,496,1062,565,565,5,560,195,365
70220,Savski Venac,14,,1283,653,1283,630,630,12,618,143,475
70220,Savski Venac,15,,1175,569,1175,606,605,5,600,155,445
70220,Savski Venac,16,,1421,675,1421,746,746,7,739,207,532
70220,Savski Venac,17,,1564,741,1564,823,823,11,812,262,550
70220,Savski Venac,18,,1081,557,1081,524,524,5,519,119,400
70220,Savski Venac,19,,1119,491,1119,628,628,9,619,152,467
70220,Savski Venac,20,,1018,510,1018,508,508,3,505,209,296
70220,Savski Venac,21,,1042,446,1042,596,596,9,587,225,362
70220,Savski Venac,22,,1720,892,1720,828,828,10,818,277,541
70220,Savski Venac,23,,1179,562,1179,617,617,7,610,204,406
70220,Savski Venac,24,,851,451,851,400,400,5,395,125,270
70220,Savski Venac,25,,1168,547,1168,621,621,13,608,176,432
70220,Savski Venac,26,,1504,715,1504,789,789,17,772,227,545
70220,Savski Venac,27,,1208,581,1208,627,627,10,617,173,444
70220,Savski Venac,28,,1030,479,1030,551,551,11,540,143,397
70220,Savski Venac,29,,1178,548,1178,630,630,13,617,164,453
70220,Savski Venac,30,,960,500,960,460,460,9,451,113,338
70220,Savski Venac,31,,1152,520,1152,632,632,9,623,156,467
70220,Savski Venac,32,,1132,535,1132,597,597,3,594,165,429
70220,Savski Venac,33,,1236,552,1236,684,684,5,679,235,444
70220,Savski Venac,34,,1805,882,1805,923,923,53,870,287,583
70220,Savski Venac,35,,1349,678,1349,671,671,13,658,210,448
70220,Savski Venac,36,,1492,705,1492,787,787,15,772,255,517
70220,Savski Venac,37,,1641,846,1641,795,795,22,773,341,432
70238,Sopot,1,,235,120,235,115,115,3,112,72,40
70238,Sopot,2,,476,285,476,191,191,2,189,106,83
70238,Sopot,3,,610,315,610,295,295,5,290,193,97
70238,Sopot,4,,406,244,406,162,162,3,159,99,60
70238,Sopot,5,,607,271,607,336,336,4,332,220,112
70238,Sopot,6,,500,270,500,230,230,6,224,166,58
70238,Sopot,7,,641,393,641,248,248,6,242,133,109
70238,Sopot,8,,354,214,354,140,140,1,139,76,63
70238,Sopot,9,,396,286,396,110,110,1,109,57,52
70238,Sopot,10,,647,386,647,261,261,5,256,152,104
70238,Sopot,11,,523,305,523,218,218,2,216,112,104
70238,Sopot,12,,678,435,678,243,243,4,239,165,74
70238,Sopot,13,,451,323,451,128,128,0,128,86,42
70238,Sopot,14,,565,334,565,231,231,1,230,137,93
70238,Sopot,15,,532,343,532,189,189,4,185,100,85
70238,Sopot,16,,571,327,571,244,244,4,240,137,103
70238,Sopot,17,,658,354,658,304,304,5,299,197,102
70238,Sopot,18,,527,292,527,235,235,3,232,161,71
70238,Sopot,19,,581,271,581,310,310,5,305,149,156
70238,Sopot,20,,590,331,590,259,259,3,256,143,113
70238,Sopot,21,,629,365,629,264,264,4,260,156,104
70238,Sopot,22,,470,291,470,179,179,1,178,93,85
70238,Sopot,23,,430,258,430,172,172,3,169,95,74
70238,Sopot,24,,537,311,537,226,226,7,219,128,91
70238,Sopot,25,,190,98,190,92,92,1,91,48,43
70238,Sopot,26,,653,374,653,279,279,0,279,120,159
70238,Sopot,27,,566,300,566,266,266,5,261,104,157
70238,Sopot,28,,540,298,540,242,242,2,240,114,126
70238,Sopot,29,,507,270,507,237,237,1,236,75,161
70238,Sopot,30,,375,211,375,164,164,7,157,58,99
70238,Sopot,31,,443,284,443,159,159,4,155,71,84
70238,Sopot,32,,525,347,525,178,178,2,176,79,97
70238,Sopot,33,,482,313,482,169,169,1,168,126,42
70246,Stari Grad,1,,1248,563,1248,685,685,4,681,172,509
70246,Stari Grad,2,,1556,812,1556,744,744,14,730,212,518
70246,Stari Grad,3,,1038,494,1038,544,544,9,535,146,389
70246,Stari Grad,4,,1083,492,1083,591,591,7,584,163,421
70246,Stari Grad,5,,1264,595,1263,669,669,12,657,176,481
70246,Stari Grad,6,,1301,674,1301,627,627,11,616,140,476
70246,Stari Grad,7,,1100,528,1100,572,572,9,563,149,414
70246,Stari Grad,8,,919,412,919,507,507,9,498,125,373
70246,Stari Grad,9,,964,475,965,489,489,7,482,126,356
70246,Stari Grad,10,,1042,513,1042,529,529,3,526,194,332
70246,Stari Grad,11,,1125,569,1125,556,556,7,549,164,385
70246,Stari Grad,12,,950,400,950,550,550,6,544,126,418
70246,Stari Grad,13,,1294,563,1294,731,731,14,717,180,537
70246,Stari Grad,14,,936,421,936,515,511,10,501,109,392
70246,Stari Grad,15,,1095,544,1095,551,551,6,545,148,397
70246,Stari Grad,16,,1133,593,1133,540,540,4,536,169,367
70246,Stari Grad,17,,1183,603,1183,580,580,3,577,140,437
70246,Stari Grad,18,,1618,871,1618,747,747,10,737,231,506
70246,Stari Grad,19,,1114,559,1114,555,555,2,553,146,407
70246,Stari Grad,20,,1038,546,1038,492,492,5,487,126,361
70246,Stari Grad,21,,1406,659,1407,747,746,8,738,161,577
70246,Stari Grad,22,,898,464,898,434,434,8,426,106,320
70246,Stari Grad,23,,957,505,957,452,452,6,446,114,332
70246,Stari Grad,24,,1119,556,1119,563,563,9,554,118,436
70246,Stari Grad,25,,915,428,915,487,487,6,481,103,378
70246,Stari Grad,26,,1096,543,1096,553,553,4,549,155,394
70246,Stari Grad,27,,1088,537,1088,551,551,10,541,131,410
70246,Stari Grad,28,,1309,635,1309,674,673,10,663,118,545
70246,Stari Grad,29,,1160,586,1160,574,573,8,565,122,443
70246,Stari Grad,30,,912,492,912,420,420,3,417,95,322
70246,Stari Grad,31,,1096,539,1096,557,557,8,549,136,413
70246,Stari Grad,32,,1075,562,1075,513,513,5,508,108,400
70246,Stari Grad,33,,871,413,871,458,458,7,451,105,346
70246,Stari Grad,34,,906,419,906,487,487,5,482,95,387
70246,Stari Grad,35,,800,410,800,390,390,3,387,103,284
70246,Stari Grad,36,,850,402,850,448,448,7,441,103,338
70246,Stari Grad,37,,973,490,973,483,483,8,475,98,377
70246,Stari Grad,38,,854,396,854,458,458,8,450,95,355
70246,Stari Grad,39,,844,426,844,418,418,1,417,81,336
70246,Stari Grad,40,,1628,759,1628,869,869,10,859,189,670
70246,Stari Grad,41,,1675,732,1675,943,943,16,927,187,740
70246,Stari Grad,42,,1366,657,1366,709,709,6,703,131,572
70246,Stari Grad,43,,1428,685,1428,743,742,12,730,176,554
70246,Stari Grad,44,,864,470,864,394,394,5,389,87,302
70246,Stari Grad,45,,730,339,730,391,391,7,384,58,326
70246,Stari Grad,46,,861,396,861,465,465,5,460,106,354
70246,Stari Grad,47,,796,402,796,394,394,5,389,95,294
70246,Stari Grad,48,,802,399,802,403,403,6,397,86,311
70246,Stari Grad,49,,1043,473,1043,570,570,8,562,124,438
70246,Stari Grad,50,,1073,503,1073,570,570,11,559,135,424
70246,Stari Grad,51,,991,459,991,532,532,3,529,103,426
70246,Stari Grad,52,,947,483,947,464,463,3,460,124,336
70246,Stari Grad,53,,944,473,944,471,471,8,463,119,344
70246,Stari Grad,54,,920,484,920,436,436,5,431,91,340
70246,Stari Grad,55,,872,426,862,446,446,3,443,111,332
70246,Stari Grad,56,,1115,545,1127,570,570,9,561,145,416
70254,Čukarica,1,,2357,1226,2357,1131,1131,19,1112,360,752
70254,Čukarica,2,,1988,1029,1988,959,957,13,944,333,611
70254,Čukarica,3,,2395,1149,2395,1246,1246,16,1230,365,865
70254,Čukarica,4,,2411,1181,2411,1230,1230,24,1206,320,886
70254,Čukarica,5,,2450,1161,2450,1289,1287,23,1264,350,914
70254,Čukarica,6,,1633,934,1633,699,699,10,689,280,409
70254,Čukarica,7,,1626,903,1626,723,723,3,720,279,441
70254,Čukarica,8,,774,462,774,312,312,8,304,164,140
70254,Čukarica,9,,2385,1131,2385,1254,1254,9,1245,383,862
70254,Čukarica,10,,1479,716,1479,763,763,14,749,261,488
70254,Čukarica,11,,1717,1032,1717,685,685,9,676,239,437
70254,Čukarica,12,,1927,1169,1927,758,758,3,755,296,459
70254,Čukarica,13,,2217,1108,2217,1109,1108,13,1095,447,648
70254,Čukarica,14,,1457,783,1459,674,674,9,665,237,428
70254,Čukarica,15,,1582,700,1583,882,882,8,874,255,619
70254,Čukarica,16,,1615,975,1615,640,640,8,632,240,392
70254,Čukarica,17,,1677,844,1677,833,833,6,827,267,560
70254,Čukarica,18,,1229,661,1229,568,567,9,558,159,399
70254,Čukarica,19,,2148,1027,2148,1121,1121,11,1110,346,764
70254,Čukarica,20,,1473,737,1473,736,736,8,728,189,539
70254,Čukarica,21,,1621,760,1621,861,860,7,853,225,628
70254,Čukarica,22,,1789,836,1789,953,952,7,945,286,659
70254,Čukarica,23,,1340,653,1340,687,687,6,681,194,487
70254,Čukarica,24,,1459,739,1460,720,720,15,705,224,481
70254,Čukarica,25,,1478,732,1479,746,746,9,737,251,486
70254,Čukarica,26,,2333,1228,2333,1105,1105,7,1098,462,636
70254,Čukarica,27,,1939,992,1939,947,947,9,938,345,593
70254,Čukarica,28,,2105,991,2105,1114,1114,10,1104,423,681
70254,Čukarica,29,,2021,1037,2021,984,983,12,971,379,592
70254,Čukarica,30,,1428,720,1428,708,708,6,702,263,439
70254,Čukarica,31,,1987,982,1987,1005,1005,12,993,388,605
70254,Čukarica,32,,1872,970,1872,902,902,6,896,332,564
70254,Čukarica,33,,2135,1066,2135,1069,1069,17,1052,407,645
70254,Čukarica,34,,2148,1019,2148,1129,1129,16,1113,394,719
70254,Čukarica,35,,1901,935,1901,966,966,7,959,328,631
70254,Čukarica,36,,1196,565,1197,631,631,10,621,237,384
70254,Čukarica,37,,1885,847,1885,1038,1038,9,1029,403,626
70254,Čukarica,38,,2544,1452,2545,1092,1091,10,1081,408,673
70254,Čukarica,39,,1297,575,1297,722,722,8,714,298,416
70254,Čukarica,40,,1448,596,1448,852,852,12,840,375,465
70254,Čukarica,41,,1155,575,1155,580,580,7,573,227,346
70254,Čukarica,42,,1512,735,1512,777,777,5,772,315,457
70254,Čukarica,43,,1564,755,1564,809,809,13,796,291,505
70254,Čukarica,44,,1361,613,1361,748,748,11,737,288,449
70254,Čukarica,45,,1710,806,1710,904,904,14,890,305,585
70254,Čukarica,46,,1432,717,1432,715,715,8,707,258,449
70254,Čukarica,47,,1652,934,1652,718,718,6,712,338,374
70254,Čukarica,48,,2461,1344,2463,1117,1116,12,1104,584,520
70254,Čukarica,49,,2422,1175,2422,1247,1247,19,1228,398,830
70254,Čukarica,50,,1694,864,1694,830,830,18,812,288,524
70254,Čukarica,51,,1288,662,1288,626,625,6,619,206,413
70254,Čukarica,52,,1469,658,1469,811,811,10,801,326,475
70254,Čukarica,53,,1559,753,1559,806,804,6,798,283,515
70254,Čukarica,54,,2254,1206,2254,1048,1048,10,1038,432,606
70254,Čukarica,55,,2144,1132,2144,1012,1012,18,994,348,646
70254,Čukarica,56,,1615,776,1615,839,838,14,824,314,510
70254,Čukarica,57,,1446,721,1446,725,725,7,718,268,450
70254,Čukarica,58,,2549,1359,2549,1190,1190,24,1166,481,685
70254,Čukarica,59,,1253,639,1253,614,614,5,609,289,320
70254,Čukarica,60,,1727,953,1727,774,774,6,768,340,428
70254,Čukarica,61,,1686,944,1686,742,742,13,729,370,359
70254,Čukarica,62,,1809,1002,1809,807,804,5,799,462,337
70254,Čukarica,63,,1323,730,1323,593,593,7,586,276,310
70254,Čukarica,64,,1162,628,1162,534,534,13,521,258,263
70254,Čukarica,65,,762,465,762,297,297,3,294,143,151
70254,Čukarica,66,,253,105,242,148,148,2,146,89,57
70254,Čukarica,67,,1685,801,1685,884,884,5,879,450,429
70254,Čukarica,68,,831,463,831,368,368,6,362,179,183
70254,Čukarica,69,,1817,894,1817,923,922,14,908,544,364
70254,Čukarica,70,,394,166,394,228,228,3,225,144,81
70254,Čukarica,71,,1518,825,1518,693,693,13,680,271,409
70254,Čukarica,72,,1599,857,1599,742,742,7,735,352,383
70254,Čukarica,73,,2429,1351,2429,1078,1078,16,1062,510,552
70254,Čukarica,74,,1963,1046,1963,917,917,18,899,368,531
70254,Čukarica,75,,1631,861,1631,770,770,12,758,376,382
70254,Čukarica,76,,1582,865,1582,717,717,8,709,323,386
70254,Čukarica,77,,2511,1381,2511,1130,1130,12,1118,603,515
70254,Čukarica,78,,1260,665,1260,595,595,5,590,267,323
70254,Čukarica,79,,1243,613,1243,630,630,4,626,323,303
70254,Čukarica,80,,1907,1072,1907,835,835,13,822,396,426
70254,Čukarica,81,,2384,1483,2374,901,901,13,888,521,367
70254,Čukarica,82,,1074,532,1073,542,542,10,532,232,300
70254,Čukarica,83,,1507,775,1507,732,732,9,723,359,364
70254,Čukarica,84,,2306,1240,2306,1066,1066,12,1054,535,519
70254,Čukarica,85,,2103,1245,2103,858,856,7,849,381,468
70254,Čukarica,86,,1039,579,1041,460,460,2,458,218,240
70254,Čukarica,87,,990,511,990,479,479,3,476,264,212
70254,Čukarica,88,,1982,1007,1982,975,975,5,970,486,484
70254,Čukarica,89,,2003,1014,2003,989,989,10,979,479,500
70254,Čukarica,90,,992,483,992,509,509,5,504,265,239
70254,Čukarica,91,,1300,661,1299,639,639,8,631,280,351
70254,Čukarica,92,,1268,686,1269,582,582,11,571,322,249
70262,Blace,1,,1301,700,1305,601,601,11,590,290,300
70262,Blace,2,,772,366,775,406,404,8,396,171,225
70262,Blace,3,,1323,716,1327,607,607,10,597,333,264
70262,Blace,4,,1083,544,1089,539,539,15,524,230,294
70262,Blace,5,,311,139,311,172,172,2,170,82,88
70262,Blace,6,,182,76,182,106,106,1,105,50,55
70262,Blace,7,,143,47,142,96,96,2,94,34,60
70262,Blace,8,,338,165,338,173,173,0,173,108,65
70262,Blace,9,,441,192,441,249,249,2,247,138,109
70262,Blace,10,,293,128,293,165,165,3,162,94,68
70262,Blace,11,,152,80,152,72,72,1,71,49,22
70262,Blace,12,,283,106,283,177,177,3,174,98,76
70262,Blace,13,,333,196,333,137,137,1,136,97,39
70262,Blace,14,,390,136,390,254,254,2,252,106,146
70262,Blace,15,,108,40,108,68,68,0,68,41,27
70262,Blace,16,,323,166,321,157,157,6,151,101,50
70262,Blace,17,,216,110,216,106,106,0,106,60,46
70262,Blace,18,,114,52,114,62,62,0,62,43,19
70262,Blace,19,,257,100,257,157,157,3,154,103,51
70262,Blace,20,,169,87,169,82,82,0,82,46,36
70262,Blace,21,,180,91,180,89,89,2,87,53,34
70262,Blace,22,,164,72,164,92,92,1,91,45,46
70262,Blace,23,,303,153,303,150,150,1,149,57,92
70262,Blace,24,,137,43,137,94,94,0,94,49,45
70262,Blace,25,,134,36,134,98,98,1,97,53,44
70262,Blace,26,,185,91,185,94,94,3,91,49,42
70262,Blace,27,,213,87,213,126,126,0,126,77,49
70262,Blace,28,,250,134,250,116,116,4,112,50,62
70262,Blace,29,,104,28,104,76,76,0,76,50,26
70262,Blace,30,,260,157,260,103,103,0,103,75,28
70262,Blace,31,,172,83,172,89,89,0,89,55,34
70262,Blace,32,,359,206,360,153,153,1,152,110,42
70262,Blace,33,,201,89,197,112,112,1,111,59,52
70289,Bogatić,1,,934,560,934,374,374,2,372,315,57
70289,Bogatić,2,,775,409,775,366,366,1,365,243,122
70289,Bogatić,3,,834,466,834,368,368,5,363,254,109
70289,Bogatić,4,,840,459,840,381,381,0,381,218,163
70289,Bogatić,5,,907,527,907,380,380,6,374,225,149
70289,Bogatić,6,,685,354,685,331,331,4,327,191,136
70289,Bogatić,7,,518,276,518,242,242,3,239,148,91
70289,Bogatić,8,,719,323,719,396,396,1,395,236,159
70289,Bogatić,9,,652,231,652,421,421,8,413,242,171
70289,Bogatić,10,,1067,464,1067,603,603,28,575,271,304
70289,Bogatić,11,,1245,553,1245,692,692,9,683,361,322
70289,Bogatić,12,,1033,538,1033,495,495,6,489,288,201
70289,Bogatić,13,,929,595,929,334,334,7,327,201,126
70289,Bogatić,14,,585,274,585,311,311,4,307,164,143
70289,Bogatić,15,,1123,619,1123,504,504,6,498,274,224
70289,Bogatić,16,,750,355,750,395,395,4,391,249,142
70289,Bogatić,17,,1101,583,1101,518,518,4,514,308,206
70289,Bogatić,18,,726,358,726,368,368,4,364,223,141
70289,Bogatić,19,,827,418,827,409,409,3,406,217,189
70289,Bogatić,20,,927,531,927,396,396,4,392,227,165
70289,Bogatić,21,,846,386,846,460,460,6,454,240,214
70289,Bogatić,22,,899,483,899,416,416,4,412,268,144
70289,Bogatić,23,,857,422,857,435,435,7,428,249,179
70289,Bogatić,24,,804,410,804,394,394,9,385,192,193
70289,Bogatić,25,,974,491,974,483,483,5,478,182,296
70289,Bogatić,26,,338,193,338,145,145,1,144,75,69
70289,Bogatić,27,,1088,642,1088,446,446,2,444,254,190
70289,Bogatić,28,,487,231,487,256,256,9,247,170,77
70289,Bogatić,29,,828,449,827,379,378,1,377,211,166
70289,Bogatić,30,,755,362,755,393,393,7,386,176,210
70289,Bogatić,31,,1054,579,1054,475,475,7,468,288,180
70297,Bojnik,1,,603,326,603,277,277,6,271,155,116
70297,Bojnik,2,,657,372,657,285,285,4,281,181,100
70297,Bojnik,3,,528,276,528,252,252,1,251,157,94
70297,Bojnik,4,,466,219,466,247,247,5,242,174,68
70297,Bojnik,5,,592,338,592,254,254,10,244,175,69
70297,Bojnik,6,,373,138,373,235,235,0,235,156,79
70297,Bojnik,7,,367,147,367,220,220,0,220,148,72
70297,Bojnik,8,,530,190,530,340,340,3,337,278,59
70297,Bojnik,9,,451,255,451,196,196,0,196,127,69
70297,Bojnik,10,,309,195,309,114,114,0,114,98,16
70297,Bojnik,11,,384,203,384,181,181,0,181,141,40
70297,Bojnik,12,,410,230,410,180,180,1,179,110,69
70297,Bojnik,13,,480,214,480,266,266,2,264,186,78
70297,Bojnik,14,,173,76,173,97,97,0,97,84,13
70297,Bojnik,15,,351,143,351,208,208,0,208,191,17
70297,Bojnik,16,,484,267,484,217,217,2,215,164,51
70297,Bojnik,17,,320,133,320,187,187,4,183,125,58
70297,Bojnik,18,,448,236,448,212,212,5,207,138,69
70297,Bojnik,19,,132,42,132,90,90,0,90,74,16
70297,Bojnik,20,,169,61,169,108,108,1,107,82,25
70297,Bojnik,21,,233,119,233,114,114,1,113,83,30
70297,Bojnik,22,,100,77,100,23,23,0,23,19,4
70297,Bojnik,23,,146,52,146,94,94,0,94,81,13
70297,Bojnik,24,,164,86,164,78,78,0,78,65,13
70297,Bojnik,25,,224,93,224,131,131,3,128,98,30
70297,Bojnik,26,,216,97,216,119,119,0,119,101,18
70297,Bojnik,27,,219,100,219,119,119,5,114,70,44
70297,Bojnik,28,,116,46,116,70,70,0,70,48,22
70297,Bojnik,29,,163,73,163,90,90,0,90,69,21
70297,Bojnik,30,,141,56,141,85,85,0,85,71,14
70319,Boljevac,1,,337,160,337,177,177,8,169,94,75
70319,Boljevac,2,,535,298,535,237,237,5,232,120,112
70319,Boljevac,3,,214,134,214,80,80,4,76,26,50
70319,Boljevac,4,,356,152,356,204,204,2,202,90,112
70319,Boljevac,5,,558,235,558,323,323,14,309,130,179
70319,Boljevac,6,,803,410,803,393,393,5,388,160,228
70319,Boljevac,7,,680,400,680,280,280,5,275,110,165
70319,Boljevac,8,,695,321,695,374,374,8,366,132,234
70319,Boljevac,9,,629,265,629,364,364,5,359,130,229
70319,Boljevac,10,,225,68,225,157,157,7,150,50,100
70319,Boljevac,11,,121,53,121,68,68,2,66,43,23
70319,Boljevac,12,,404,227,404,177,177,1,176,86,90
70319,Boljevac,13,,191,100,191,91,91,5,86,60,26
70319,Boljevac,14,,100,45,100,55,55,0,55,34,21
70319,Boljevac,15,,359,141,359,218,218,2,216,78,138
70319,Boljevac,16,,438,232,438,206,206,4,202,100,102
70319,Boljevac,17,,676,536,676,140,140,0,140,46,94
70319,Boljevac,18,,425,295,425,130,130,2,128,52,76
70319,Boljevac,19,,477,221,477,256,256,2,254,129,125
70319,Boljevac,20,,160,57,160,103,103,0,103,44,59
70319,Boljevac,21,,177,62,177,115,115,0,115,48,67
70319,Boljevac,22,,382,180,382,202,202,1,201,82,119
70319,Boljevac,23,,331,174,331,157,157,7,150,39,111
70319,Boljevac,24,,444,218,444,226,226,6,220,114,106
70319,Boljevac,25,,397,208,397,189,189,4,185,70,115
70319,Boljevac,26,,106,26,106,80,80,0,80,18,62
70319,Boljevac,27,,176,90,176,86,86,3,83,38,45
70319,Boljevac,28,,339,205,339,134,134,3,131,58,73
70319,Boljevac,29,,453,253,453,200,200,8,192,93,99
70319,Boljevac,30,,443,260,443,183,183,6,177,87,90
70319,Boljevac,31,,292,149,292,143,143,0,143,51,92
70319,Boljevac,32,,321,207,321,114,114,4,110,45,65
70319,Boljevac,33,,147,84,147,63,63,0,63,15,48
70319,Boljevac,34,,191,63,191,128,128,5,123,40,83
70319,Boljevac,35,,255,120,255,135,135,1,134,69,65
70319,Boljevac,36,,311,188,311,123,123,1,122,34,88
70319,Boljevac,37,,297,149,297,148,148,0,148,40,108
70327,Bor,1,,879,584,879,295,295,3,292,143,149
70327,Bor,2,,1110,765,1110,345,344,5,339,199,140
70327,Bor,3,,1358,838,1356,520,520,8,512,281,231
70327,Bor,4,,1584,967,1584,617,617,11,606,326,280
70327,Bor,5,,885,508,887,377,377,3,374,172,202
70327,Bor,6,,987,561,987,426,426,4,422,206,216
70327,Bor,7,,1230,704,1231,526,526,5,521,193,328
70327,Bor,8,,1121,695,1121,426,426,1,425,256,169
70327,Bor,9,,1065,623,1066,442,442,7,435,183,252
70327,Bor,10,,1263,797,1263,466,466,12,454,233,221
70327,Bor,11,,1187,699,1187,488,488,4,484,229,255
70327,Bor,12,,1543,783,1543,760,760,11,749,337,412
70327,Bor,13,,1505,900,1505,605,605,8,597,261,336
70327,Bor,14,,1075,523,1075,552,552,2,550,194,356
70327,Bor,15,,1339,702,1339,637,637,11,626,262,364
70327,Bor,16,,1033,572,1033,461,461,7,454,186,268
70327,Bor,17,,1402,776,1402,626,626,6,620,259,361
70327,Bor,18,,1247,750,1247,497,497,9,488,209,279
70327,Bor,19,,1342,670,1342,672,672,9,663,276,387
70327,Bor,20,,1464,724,1464,740,740,21,719,241,478
70327,Bor,21,,1229,649,1229,580,580,6,574,168,406
70327,Bor,22,,1678,802,1678,876,876,12,864,321,543
70327,Bor,23,,1100,596,1100,504,503,5,498,191,307
70327,Bor,24,,782,479,782,303,303,5,298,112,186
70327,Bor,25,,825,466,825,359,359,6,353,194,159
70327,Bor,26,,909,495,909,414,414,7,407,173,234
70327,Bor,27,,1568,845,1568,723,723,2,721,317,404
70327,Bor,28,,1506,740,1506,766,766,9,757,286,471
70327,Bor,29,,999,473,999,526,526,11,515,209,306
70327,Bor,30,,838,555,838,283,283,2,281,145,136
70327,Bor,31,,1276,709,1276,567,567,6,561,270,291
70327,Bor,32,,361,217,361,144,144,1,143,96,47
70327,Bor,33,,485,250,485,235,235,2,233,128,105
70327,Bor,34,,978,552,978,426,426,3,423,233,190
70327,Bor,35,,458,301,458,157,157,2,155,74,81
70327,Bor,36,,948,690,948,258,258,4,254,96,158
70327,Bor,37,,710,427,710,283,283,4,279,151,128
70327,Bor,38,,932,563,932,369,369,6,363,181,182
70327,Bor,39,,759,485,759,274,274,2,272,129,143
70327,Bor,40,,528,253,528,275,275,8,267,124,143
70327,Bor,41,,683,422,683,261,261,10,251,162,89
70327,Bor,42,,529,358,529,171,171,2,169,95,74
70327,Bor,43,,577,321,577,256,256,5,251,85,166
70327,Bor,44,,474,277,474,197,197,2,195,93,102
70327,Bor,45,,523,314,523,209,209,3,206,90,116
70327,Bor,46,,526,347,526,179,179,2,177,127,50
70327,Bor,47,,262,169,262,93,92,0,92,55,37
70327,Bor,48,,288,184,288,104,104,3,101,66,35
70335,Bosilegrad,1,,695,314,695,381,381,25,356,132,224
70335,Bosilegrad,2,,875,460,875,415,415,9,406,196,210
70335,Bosilegrad,3,,257,154,257,103,103,5,98,38,60
70335,Bosilegrad,4,,405,165,406,240,240,12,228,95,133
70335,Bosilegrad,5,,133,72,133,61,61,6,55,14,41
70335,Bosilegrad,6,,670,454,670,216,216,5,211,101,110
70335,Bosilegrad,7,,741,455,741,286,286,4,282,122,160
70335,Bosilegrad,8,,320,249,320,71,71,0,71,30,41
70335,Bosilegrad,9,,383,284,383,99,99,2,97,68,29
70335,Bosilegrad,10,,241,183,241,58,58,0,58,41,17
70335,Bosilegrad,11,,381,301,381,80,80,3,77,39,38
70335,Bosilegrad,12,,381,239,381,142,142,2,140,72,68
70335,Bosilegrad,13,,286,158,286,128,128,3,125,67,58
70335,Bosilegrad,14,,187,122,187,65,65,4,61,34,27
70335,Bosilegrad,15,,127,86,127,41,41,2,39,21,18
70335,Bosilegrad,16,,129,60,129,69,69,0,69,36,33
70335,Bosilegrad,17,,193,142,193,51,51,0,51,21,30
70335,Bosilegrad,18,,210,162,210,48,48,1,47,25,22
70335,Bosilegrad,19,,234,164,234,70,70,3,67,30,37
70335,Bosilegrad,20,,135,100,135,35,35,0,35,27,8
70335,Bosilegrad,21,,179,132,179,47,47,1,46,21,25
70335,Bosilegrad,22,,135,80,135,55,55,0,55,37,18
70335,Bosilegrad,23,,130,70,130,60,60,4,56,22,34
70335,Bosilegrad,24,,326,201,326,125,125,4,121,77,44
70335,Bosilegrad,25,,126,84,126,42,42,1,41,20,21
70335,Bosilegrad,26,,164,121,164,43,43,1,42,27,15
70335,Bosilegrad,27,,262,213,262,49,49,2,47,25,22
70335,Bosilegrad,28,,157,93,157,64,64,1,63,24,39
70335,Bosilegrad,29,,107,84,107,23,23,1,22,13,9
70335,Bosilegrad,30,,249,191,249,58,58,0,58,39,19
70335,Bosilegrad,31,,172,115,172,57,57,0,57,28,29
70343,Brus,1,,401,221,401,180,180,4,176,84,92
70343,Brus,2,,128,80,128,48,48,0,48,24,24
70343,Brus,3,,155,95,155,60,60,0,60,29,31
70343,Brus,4,,111,68,111,43,43,0,43,22,21
70343,Brus,5,,164,84,164,80,80,1,79,42,37
70343,Brus,6,,119,66,119,53,53,0,53,26,27
70343,Brus,7,,133,86,133,47,47,1,46,32,14
70343,Brus,8,,215,90,215,125,125,2,123,57,66
70343,Brus,9,,116,63,116,53,53,0,53,39,14
70343,Brus,10,,146,69,146,77,77,3,74,35,39
70343,Brus,11,,414,244,414,170,170,2,168,108,60
70343,Brus,12,,104,39,104,65,65,0,65,49,16
70343,Brus,13,,573,406,573,167,167,0,167,91,76
70343,Brus,14,,471,248,471,223,223,3,220,129,91
70343,Brus,15,,646,269,646,377,377,7,370,149,221
70343,Brus,16,,409,194,409,215,215,7,208,83,125
70343,Brus,17,,1024,597,1024,427,427,7,420,204,216
70343,Brus,18,,558,254,558,304,304,1,303,88,215
70343,Brus,19,,316,119,316,197,197,8,189,90,99
70343,Brus,20,,357,152,357,205,205,2,203,77,126
70343,Brus,21,,613,355,613,258,258,3,255,107,148
70343,Brus,22,,502,353,502,149,149,1,148,101,47
70343,Brus,23,,159,100,159,59,59,0,59,28,31
70343,Brus,24,,382,235,382,147,147,3,144,80,64
70343,Brus,25,,226,127,226,99,99,0,99,53,46
70343,Brus,26,,248,149,248,99,99,2,97,61,36
70343,Brus,27,,295,197,295,98,98,0,98,40,58
70343,Brus,28,,464,272,464,192,192,0,192,83,109
70343,Brus,29,,505,309,505,196,196,2,194,154,40
70343,Brus,30,,748,407,748,341,341,6,335,201,134
70343,Brus,31,,300,145,300,155,155,2,153,87,66
70343,Brus,32,,181,67,181,114,114,1,113,55,58
70343,Brus,33,,532,237,532,295,295,3,292,167,125
70343,Brus,34,,404,195,404,209,209,6,203,149,54
70343,Brus,35,,358,201,358,157,157,0,157,98,59
70343,Brus,36,,157,86,157,71,71,2,69,55,14
70343,Brus,37,,316,174,316,142,142,2,140,110,30
70343,Brus,38,,421,218,421,203,203,5,198,133,65
70343,Brus,39,,183,82,183,101,101,0,101,79,22
70343,Brus,40,,272,138,272,134,134,0,134,100,34
70343,Brus,41,,129,88,129,41,41,0,41,28,13
70343,Brus,42,,352,162,352,190,190,4,186,121,65
70343,Brus,43,,139,64,139,75,75,4,71,55,16
70343,Brus,44,,194,122,194,72,72,0,72,47,25
70343,Brus,45,,149,91,149,58,58,0,58,35,23
70343,Brus,46,,166,116,166,50,50,0,50,24,26
70343,Brus,47,,185,130,185,55,55,0,55,36,19
70343,Brus,48,,484,271,484,213,213,4,209,110,99
70351,Bujanovac,1,,1289,1273,1289,16,16,0,16,0,16
70351,Bujanovac,2,,1284,1268,1284,16,16,0,16,0,16
70351,Bujanovac,3,,307,307,307,0,0,0,0,0,0
70351,Bujanovac,4,,772,766,772,6,6,0,6,0,6
70351,Bujanovac,5,,1608,1604,1608,4,4,0,4,0,4
70351,Bujanovac,6,,303,303,303,0,0,0,0,0,0
70351,Bujanovac,7,,1110,1110,1110,0,0,0,0,0,0
70351,Bujanovac,8,,1071,1071,1071,0,0,0,0,0,0
70351,Bujanovac,9,,773,773,773,0,0,0,0,0,0
70351,Bujanovac,10,,221,211,221,10,10,0,10,10,0
70351,Bujanovac,11,,429,429,429,0,0,0,0,0,0
70351,Bujanovac,12,,238,238,238,0,0,0,0,0,0
70351,Bujanovac,13,,549,532,549,17,17,0,17,0,17
70351,Bujanovac,14,,1138,1138,1138,0,0,0,0,0,0
70351,Bujanovac,15,,973,973,973,0,0,0,0,0,0
70351,Bujanovac,16,,579,579,579,0,0,0,0,0,0
70351,Bujanovac,17,,916,907,916,9,9,0,9,7,2
70351,Bujanovac,18,,1456,1405,1456,51,49,0,49,37,12
70351,Bujanovac,19,,802,764,802,38,38,1,37,5,32
70351,Bujanovac,20,,450,394,450,56,56,0,56,50,6
70351,Bujanovac,21,,128,86,128,42,42,0,42,32,10
70351,Bujanovac,22,,731,450,731,281,281,1,280,257,23
70351,Bujanovac,23,,200,96,200,104,104,0,104,80,24
70351,Bujanovac,24,,322,195,322,127,127,1,126,99,27
70351,Bujanovac,25,,901,365,901,536,536,5,531,442,89
70351,Bujanovac,26,,702,308,702,394,394,6,388,309,79
70351,Bujanovac,27,,808,656,808,152,150,1,149,121,28
70351,Bujanovac,28,,288,101,288,187,187,0,187,124,63
70351,Bujanovac,29,,151,63,151,88,88,0,88,79,9
70351,Bujanovac,30,,497,193,497,304,304,2,302,237,65
70351,Bujanovac,31,,135,28,135,107,107,1,106,88,18
70351,Bujanovac,32,,110,22,110,88,88,0,88,83,5
70351,Bujanovac,33,,604,363,604,241,241,5,236,214,22
70351,Bujanovac,34,,425,270,426,155,155,2,153,116,37
70351,Bujanovac,35,,463,285,463,178,178,1,177,148,29
70351,Bujanovac,36,,202,80,202,122,122,1,121,110,11
70351,Bujanovac,37,,533,204,533,329,329,4,325,231,94
70351,Bujanovac,38,,177,100,177,77,77,0,77,62,15
70351,Bujanovac,39,,155,55,155,100,100,0,100,67,33
70351,Bujanovac,40,,242,51,242,191,191,0,191,163,28
70351,Bujanovac,41,,163,60,163,103,103,0,103,81,22
70351,Bujanovac,42,,343,187,344,156,156,3,153,129,24
70351,Bujanovac,43,,223,135,223,88,88,1,87,72,15
70351,Bujanovac,44,,105,53,105,52,52,0,52,47,5
70351,Bujanovac,45,,121,55,121,66,66,1,65,59,6
70351,Bujanovac,46,,973,498,973,475,475,5,470,314,156
70351,Bujanovac,47,,999,557,1002,442,442,4,438,299,139
70351,Bujanovac,48,,886,819,886,67,67,0,67,49,18
70351,Bujanovac,49,,637,292,637,345,345,5,340,220,120
70351,Bujanovac,50,,486,336,486,150,150,0,150,106,44
70351,Bujanovac,51,,446,237,446,209,209,4,205,136,69
70351,Bujanovac,52,,1651,1467,1651,184,184,10,174,122,52
70351,Bujanovac,53,,1127,858,1127,269,269,2,267,170,97
70351,Bujanovac,54,,779,533,780,246,246,8,238,160,78
70351,Bujanovac,55,,552,547,552,5,5,0,5,1,4
70351,Bujanovac,56,,1005,475,1005,530,530,21,509,279,230
70351,Bujanovac,57,,1899,1864,1899,35,35,0,35,26,9
70360,Valjevo,1,,1652,815,1652,837,837,18,819,279,540
70360,Valjevo,2,,1680,784,1680,896,895,15,880,285,595
70360,Valjevo,3,,304,166,304,138,138,2,136,52,84
70360,Valjevo,4,,1760,833,1760,927,927,17,910,381,529
70360,Valjevo,5,,1621,729,1622,892,892,26,866,263,603
70360,Valjevo,6,,1440,630,1440,810,810,18,792,265,527
70360,Valjevo,7,,622,305,622,317,317,5,312,102,210
70360,Valjevo,8,,1040,467,1040,573,573,10,563,222,341
70360,Valjevo,9,,1170,553,1170,617,617,11,606,211,395
70360,Valjevo,10,,1803,729,1803,1074,1074,23,1051,317,734
70360,Valjevo,11,,2241,1100,2241,1141,1141,15,1126,461,665
70360,Valjevo,12,,1738,967,1737,771,771,13,758,350,408
70360,Valjevo,13,,1741,923,1741,818,818,17,801,361,440
70360,Valjevo,14,,492,315,492,177,177,1,176,68,108
70360,Valjevo,15,,1761,729,1761,1032,1032,26,1006,287,719
70360,Valjevo,16,,1606,659,1606,947,947,21,926,270,656
70360,Valjevo,17,,1131,471,1132,660,660,17,643,190,453
70360,Valjevo,18,,1360,587,1360,773,773,21,752,272,480
70360,Valjevo,19,,1479,612,1479,867,867,17,850,255,595
70360,Valjevo,20,,1830,717,1830,1113,1111,30,1081,367,714
70360,Valjevo,21,,1106,478,1107,628,628,17,611,238,373
70360,Valjevo,22,,2400,1102,2400,1298,1298,24,1274,498,776
70360,Valjevo,23,,1953,884,1953,1069,1069,15,1054,500,554
70360,Valjevo,24,,2054,987,2054,1067,1067,24,1043,428,615
70360,Valjevo,25,,2005,915,2008,1090,1090,14,1076,432,644
70360,Valjevo,26,,1345,577,1345,768,766,16,750,322,428
70360,Valjevo,27,,1332,597,1332,735,735,21,714,312,402
70360,Valjevo,28,,1615,705,1615,910,910,39,871,261,610
70360,Valjevo,29,,1912,958,1913,954,954,14,940,387,553
70360,Valjevo,30,,1705,733,1705,972,972,18,954,380,574
70360,Valjevo,31,,2450,1268,2451,1182,1181,26,1155,470,685
70360,Valjevo,32,,1834,793,1834,1041,1041,17,1024,368,656
70360,Valjevo,33,,235,152,235,83,83,2,81,45,36
70360,Valjevo,34,,290,143,290,147,147,2,145,60,85
70360,Valjevo,35,,445,234,445,211,211,4,207,97,110
70360,Valjevo,36,,114,86,114,28,28,0,28,13,15
70360,Valjevo,37,,166,105,166,61,61,1,60,29,31
70360,Valjevo,38,,254,139,254,115,115,0,115,55,60
70360,Valjevo,39,,132,37,132,95,95,0,95,40,55
70360,Valjevo,40,,143,77,143,66,66,0,66,40,26
70360,Valjevo,41,,100,34,100,66,66,0,66,28,38
70360,Valjevo,42,,123,70,123,53,53,0,53,26,27
70360,Valjevo,43,,223,95,223,128,128,2,126,39,87
70360,Valjevo,44,,186,81,186,105,105,2,103,48,55
70360,Valjevo,45,,1096,614,1096,482,482,7,475,191,284
70360,Valjevo,46,,456,315,456,141,141,2,139,27,112
70360,Valjevo,47,,109,42,109,67,67,1,66,16,50
70360,Valjevo,48,,121,62,121,59,59,1,58,33,25
70360,Valjevo,49,,261,140,261,121,121,2,119,38,81
70360,Valjevo,50,,469,304,469,165,165,4,161,83,78
70360,Valjevo,51,,211,147,211,64,64,3,61,36,25
70360,Valjevo,52,,165,107,165,58,58,0,58,31,27
70360,Valjevo,53,,124,51,124,73,73,3,70,50,20
70360,Valjevo,54,,189,82,189,107,107,0,107,71,36
70360,Valjevo,55,,234,110,234,124,124,3,121,52,69
70360,Valjevo,56,,294,162,294,132,132,0,132,74,58
70360,Valjevo,57,,129,62,129,67,67,0,67,22,45
70360,Valjevo,58,,188,118,188,70,70,4,66,22,44
70360,Valjevo,59,,222,106,222,116,116,2,114,52,62
70360,Valjevo,60,,357,209,357,148,148,3,145,91,54
70360,Valjevo,61,,163,88,163,75,75,2,73,25,48
70360,Valjevo,62,,142,95,142,47,47,0,47,25,22
70360,Valjevo,63,,161,86,161,75,75,1,74,26,48
70360,Valjevo,64,,474,271,474,203,203,5,198,56,142
70360,Valjevo,65,,163,84,163,79,79,2,77,41,36
70360,Valjevo,66,,366,208,366,158,158,1,157,56,101
70360,Valjevo,67,,680,373,680,307,307,3,304,130,174
70360,Valjevo,68,,693,403,693,290,290,5,285,130,155
70360,Valjevo,69,,578,234,578,344,344,7,337,178,159
70360,Valjevo,70,,438,192,438,246,246,3,243,110,133
70360,Valjevo,71,,695,369,695,326,326,5,321,151,170
70360,Valjevo,72,,450,261,450,189,189,1,188,59,129
70360,Valjevo,73,,433,264,433,169,169,1,168,83,85
70360,Valjevo,74,,243,102,243,141,141,4,137,59,78
70360,Valjevo,75,,108,60,108,48,48,0,48,43,5
70360,Valjevo,76,,1543,820,1543,723,723,17,706,406,300
70360,Valjevo,77,,635,345,635,290,290,4,286,142,144
70360,Valjevo,78,,1149,681,1149,468,468,15,453,226,227
70360,Valjevo,79,,1829,838,1829,991,991,18,973,526,447
70360,Valjevo,80,,793,454,793,339,339,6,333,174,159
70360,Valjevo,81,,1059,700,1059,359,359,5,354,147,207
70360,Valjevo,82,,407,263,407,144,144,6,138,60,78
70360,Valjevo,83,,141,85,141,56,56,0,56,41,15
70360,Valjevo,84,,331,183,331,148,148,0,148,83,65
70360,Valjevo,85,,126,83,126,43,43,0,43,9,34
70360,Valjevo,86,,202,116,202,86,86,0,86,40,46
70360,Valjevo,87,,210,108,210,102,102,5,97,42,55
70360,Valjevo,88,,385,237,385,148,148,1,147,65,82
70360,Valjevo,89,,137,61,137,76,76,1,75,26,49
70360,Valjevo,90,,207,112,207,95,95,1,94,37,57
70360,Valjevo,91,,313,167,313,146,146,5,141,87,54
70360,Valjevo,92,,328,213,339,115,115,0,115,63,52
70360,Valjevo,93,,121,46,121,75,75,1,74,39,35
70360,Valjevo,94,,551,334,551,217,217,2,215,74,141
70360,Valjevo,95,,340,184,340,156,156,2,154,91,63
70360,Valjevo,96,,452,278,452,174,174,4,170,56,114
70360,Valjevo,97,,370,254,370,116,116,1,115,48,67
70360,Valjevo,98,,497,228,497,269,269,5,264,149,115
70360,Valjevo,99,,329,194,329,135,135,2,133,61,72
70360,Valjevo,100,,176,98,176,78,78,4,74,47,27
70360,Valjevo,101,,316,162,316,154,154,1,153,67,86
70360,Valjevo,102,,156,67,156,89,89,2,87,60,27
70360,Valjevo,103,,314,172,314,142,142,5,137,80,57
70360,Valjevo,104,,591,347,591,244,244,2,242,150,92
70360,Valjevo,105,,396,196,396,200,200,4,196,146,50
70360,Valjevo,106,,344,204,344,140,140,0,140,101,39
70360,Valjevo,107,,539,289,539,250,250,3,247,113,134
70360,Valjevo,108,,119,70,119,49,49,0,49,24,25
70360,Valjevo,109,,157,32,157,125,125,3,122,67,55
70360,Valjevo,110,,219,107,219,112,112,2,110,53,57
70360,Valjevo,111,,167,68,167,99,99,2,97,74,23
70360,Valjevo,112,,113,50,113,63,63,0,63,49,14
70360,Valjevo,113,,482,286,482,196,196,1,195,124,71
70360,Valjevo,114,,137,63,137,74,74,5,69,28,41
70360,Valjevo,115,,146,71,146,75,75,2,73,42,31
70360,Valjevo,116,,398,225,398,173,173,0,173,75,98
70360,Valjevo,117,,207,122,207,85,85,2,83,23,60
70360,Valjevo,118,,154,96,154,58,58,0,58,37,21
70378,Varvarin,1,,510,320,510,190,190,2,188,96,92
70378,Varvarin,2,,549,349,549,200,200,4,196,66,130
70378,Varvarin,3,,434,263,434,171,171,4,167,92,75
70378,Varvarin,4,,495,270,495,225,225,1,224,83,141
70378,Varvarin,5,,504,294,504,210,210,2,208,137,71
70378,Varvarin,6,,549,353,549,196,196,3,193,97,96
70378,Varvarin,7,,498,321,498,177,177,4,173,108,65
70378,Varvarin,8,,502,216,502,286,286,10,276,106,170
70378,Varvarin,9,,647,276,648,371,370,6,364,146,218
70378,Varvarin,10,,685,313,685,372,372,8,364,146,218
70378,Varvarin,11,,475,221,475,254,254,3,251,133,118
70378,Varvarin,12,,476,283,476,193,193,3,190,87,103
70378,Varvarin,13,,489,288,489,201,201,2,199,77,122
70378,Varvarin,14,,449,231,449,218,218,0,218,115,103
70378,Varvarin,15,,334,164,334,170,170,6,164,89,75
70378,Varvarin,16,,430,239,430,191,191,2,189,81,108
70378,Varvarin,17,,210,124,210,86,86,1,85,36,49
70378,Varvarin,18,,398,149,398,249,249,6,243,147,96
70378,Varvarin,19,,430,199,430,231,231,5,226,154,72
70378,Varvarin,20,,296,129,296,167,167,3,164,87,77
70378,Varvarin,21,,367,234,367,133,133,3,130,85,45
70378,Varvarin,22,,368,226,368,142,142,3,139,94,45
70378,Varvarin,23,,474,318,474,156,156,4,152,60,92
70378,Varvarin,24,,342,191,342,151,150,3,147,76,71
70378,Varvarin,25,,248,99,248,149,149,0,149,69,80
70378,Varvarin,26,,364,218,364,146,146,1,145,85,60
70378,Varvarin,27,,397,189,397,208,208,3,205,106,99
70378,Varvarin,28,,559,352,559,207,207,3,204,165,39
70378,Varvarin,29,,575,408,575,167,167,1,166,110,56
70378,Varvarin,30,,596,363,596,233,233,4,229,143,86
70378,Varvarin,31,,645,400,645,245,245,4,241,134,107
70378,Varvarin,32,,595,432,595,163,163,2,161,110,51
70378,Varvarin,33,,328,180,328,148,148,1,147,99,48
70378,Varvarin,34,,310,171,310,139,139,1,138,93,45
70378,Varvarin,35,,117,42,117,75,75,0,75,49,26
70378,Varvarin,36,,428,230,428,198,198,4,194,122,72
70378,Varvarin,37,,526,441,526,85,85,1,84,22,62
70378,Varvarin,38,,279,138,279,141,141,2,139,69,70
70378,Varvarin,39,,203,101,203,102,102,1,101,69,32
70378,Varvarin,40,,211,89,211,122,122,4,118,54,64
70386,Velika Plana,1,,891,582,891,309,309,1,308,206,102
70386,Velika Plana,2,,1064,644,1064,420,420,1,419,247,172
70386,Velika Plana,3,,871,550,871,321,321,3,318,149,169
70386,Velika Plana,4,,994,632,994,362,361,5,356,239,117
70386,Velika Plana,5,,952,617,952,335,335,5,330,158,172
70386,Velika Plana,6,,910,532,910,378,378,11,367,199,168
70386,Velika Plana,7,,886,499,886,387,387,13,374,203,171
70386,Velika Plana,8,,981,521,981,460,460,7,453,287,166
70386,Velika Plana,9,,860,417,860,443,443,6,437,272,165
70386,Velika Plana,10,,913,499,913,414,414,7,407,231,176
70386,Velika Plana,11,,949,487,949,462,462,12,450,275,175
70386,Velika Plana,12,,601,367,601,234,234,5,229,124,105
70386,Velika Plana,13,,266,159,266,107,107,4,103,62,41
70386,Velika Plana,14,,1021,618,1021,403,403,5,398,232,166
70386,Velika Plana,15,,853,400,853,453,453,7,446,271,175
70386,Velika Plana,16,,166,72,166,94,94,0,94,62,32
70386,Velika Plana,17,,926,443,926,483,483,7,476,264,212
70386,Velika Plana,18,,984,612,984,372,372,4,368,166,202
70386,Velika Plana,19,,917,567,917,350,350,3,347,220,127
70386,Velika Plana,20,,1268,642,1272,626,625,6,619,348,271
70386,Velika Plana,21,,1353,666,1352,687,685,5,680,431,249
70386,Velika Plana,22,,933,407,933,526,526,14,512,222,290
70386,Velika Plana,23,,1515,799,1515,716,716,9,707,360,347
70386,Velika Plana,24,,1146,523,1146,623,623,10,613,210,403
70386,Velika Plana,25,,1003,494,1004,509,509,13,496,262,234
70386,Velika Plana,26,,942,432,942,510,510,13,497,248,249
70386,Velika Plana,27,,1323,694,1323,629,629,12,617,346,271
70386,Velika Plana,28,,1098,612,1099,486,486,2,484,334,150
70386,Velika Plana,29,,926,413,927,513,513,8,505,208,297
70386,Velika Plana,30,,1056,596,1054,460,460,7,453,252,201
70386,Velika Plana,31,,473,215,473,258,258,4,254,158,96
70386,Velika Plana,32,,308,171,308,137,137,1,136,103,33
70386,Velika Plana,33,,669,388,671,281,281,4,277,172,105
70386,Velika Plana,34,,538,324,538,214,214,5,209,139,70
70386,Velika Plana,35,,966,600,966,366,366,2,364,166,198
70386,Velika Plana,36,,1097,719,1097,378,378,5,373,231,142
70386,Velika Plana,37,,593,392,593,201,201,3,198,74,124
70386,Velika Plana,38,,379,225,379,154,154,1,153,74,79
70386,Velika Plana,39,,1262,791,1262,471,471,17,454,247,207
70386,Velika Plana,40,,918,476,919,442,442,3,439,217,222
70386,Velika Plana,41,,994,585,994,409,409,3,406,241,165
70386,Velika Plana,42,,869,507,869,362,362,2,360,220,140
70386,Velika Plana,43,,128,73,128,55,55,2,53,27,26
70386,Velika Plana,44,,1010,611,1010,399,399,7,392,202,190
70386,Velika Plana,45,,419,244,419,175,174,2,172,120,52
70386,Velika Plana,46,,160,88,160,72,72,2,70,39,31
70386,Velika Plana,47,,229,126,229,103,103,4,99,62,37
70394,Veliko Gradište,1,,451,287,451,164,164,1,163,103,60
70394,Veliko Gradište,2,,828,435,828,393,393,5,388,214,174
70394,Veliko Gradište,3,,1096,569,1096,527,527,16,511,290,221
70394,Veliko Gradište,4,,907,445,907,462,462,6,456,196,260
70394,Veliko Gradište,5,,869,402,869,467,467,10,457,205,252
70394,Veliko Gradište,6,,1262,659,1262,603,603,13,590,295,295
70394,Veliko Gradište,7,,306,161,306,145,145,2,143,55,88
70394,Veliko Gradište,8,,807,549,807,258,257,2,255,98,157
70394,Veliko Gradište,9,,596,421,596,175,175,1,174,103,71
70394,Veliko Gradište,10,,383,289,383,94,94,3,91,57,34
70394,Veliko Gradište,11,,769,540,769,229,229,2,227,153,74
70394,Veliko Gradište,12,,354,197,354,157,157,4,153,86,67
70394,Veliko Gradište,13,,686,408,686,278,278,0,278,175,103
70394,Veliko Gradište,14,,424,269,424,155,155,2,153,90,63
70394,Veliko Gradište,15,,475,329,475,146,146,0,146,81,65
70394,Veliko Gradište,16,,479,299,479,180,180,1,179,110,69
70394,Veliko Gradište,17,,645,367,645,278,278,5,273,114,159
70394,Veliko Gradište,18,,488,341,488,147,147,3,144,55,89
70394,Veliko Gradište,19,,590,366,590,224,224,5,219,127,92
70394,Veliko Gradište,20,,517,315,517,202,202,7,195,113,82
70394,Veliko Gradište,21,,424,254,424,170,170,2,168,94,74
70394,Veliko Gradište,22,,509,278,509,231,231,3,228,129,99
70394,Veliko Gradište,23,,287,127,287,160,160,6,154,88,66
70394,Veliko Gradište,24,,305,158,305,147,147,0,147,129,18
70394,Veliko Gradište,25,,686,349,686,337,337,2,335,233,102
70394,Veliko Gradište,26,,164,107,164,57,57,1,56,37,19
70394,Veliko Gradište,27,,280,175,280,105,105,1,104,65,39
70394,Veliko Gradište,28,,469,327,469,142,142,1,141,76,65
70394,Veliko Gradište,29,,409,284,409,125,125,2,123,80,43
70394,Veliko Gradište,30,,527,286,527,241,241,5,236,106,130
70394,Veliko Gradište,31,,713,543,713,170,170,1,169,91,78
70394,Veliko Gradište,32,,624,480,624,144,144,2,142,103,39
70394,Veliko Gradište,33,,469,210,469,259,259,5,254,165,89
70394,Veliko Gradište,34,,857,505,857,352,352,7,345,235,110
70394,Veliko Gradište,35,,739,478,739,261,261,7,254,155,99
70394,Veliko Gradište,36,,218,135,218,83,83,0,83,70,13
70408,Vladimirci,1,,461,245,461,216,216,7,209,121,88
70408,Vladimirci,2,,272,151,272,121,121,2,119,72,47
70408,Vladimirci,3,,209,120,209,89,89,0,89,52,37
70408,Vladimirci,4,,250,100,250,150,150,4,146,99,47
70408,Vladimirci,5,,1171,538,1171,633,633,13,620,304,316
70408,Vladimirci,6,,507,315,507,192,192,2,190,127,63
70408,Vladimirci,7,,405,236,405,169,169,5,164,89,75
70408,Vladimirci,8,,535,281,535,254,254,2,252,175,77
70408,Vladimirci,9,,792,384,792,408,408,5,403,268,135
70408,Vladimirci,10,,646,344,646,302,302,5,297,228,69
70408,Vladimirci,11,,598,323,598,275,275,5,270,179,91
70408,Vladimirci,12,,573,321,573,252,252,5,247,124,123
70408,Vladimirci,13,,145,83,145,62,62,0,62,43,19
70408,Vladimirci,14,,264,136,264,128,128,1,127,93,34
70408,Vladimirci,15,,498,245,498,253,253,7,246,163,83
70408,Vladimirci,16,,359,268,359,91,91,1,90,41,49
70408,Vladimirci,17,,291,159,291,132,132,2,130,58,72
70408,Vladimirci,18,,266,119,266,147,147,3,144,80,64
70408,Vladimirci,19,,158,45,158,113,113,1,112,66,46
70408,Vladimirci,20,,855,599,855,256,256,5,251,167,84
70408,Vladimirci,21,,222,117,222,105,105,2,103,66,37
70408,Vladimirci,22,,218,97,218,121,121,2,119,84,35
70408,Vladimirci,23,,208,101,208,107,107,2,105,76,29
70408,Vladimirci,24,,191,86,191,105,105,1,104,50,54
70408,Vladimirci,25,,268,152,268,116,116,3,113,76,37
70408,Vladimirci,26,,302,217,302,85,85,4,81,56,25
70408,Vladimirci,27,,234,132,234,102,102,0,102,74,28
70408,Vladimirci,28,,309,147,309,162,162,3,159,90,69
70408,Vladimirci,29,,282,139,282,143,143,0,143,109,34
70408,Vladimirci,30,,465,238,465,227,227,2,225,172,53
70408,Vladimirci,31,,507,318,507,189,189,3,186,87,99
70408,Vladimirci,32,,387,165,387,222,222,3,219,145,74
70408,Vladimirci,33,,189,87,189,102,102,4,98,63,35
70408,Vladimirci,34,,458,262,458,196,196,1,195,98,97
70408,Vladimirci,35,,532,256,532,276,276,2,274,165,109
70408,Vladimirci,36,,589,410,589,179,179,0,179,91,88
70408,Vladimirci,37,,357,177,357,180,180,2,178,112,66
70408,Vladimirci,38,,121,42,121,79,79,4,75,37,38
70408,Vladimirci,39,,199,66,199,133,133,1,132,94,38
70408,Vladimirci,40,,823,408,823,415,415,7,408,220,188
70408,Vladimirci,41,,368,222,368,146,146,3,143,63,80
70408,Vladimirci,42,,291,122,291,169,169,2,167,88,79
70416,Vladičin Han,1,,506,196,506,310,310,4,306,150,156
70416,Vladičin Han,2,,756,308,757,448,448,7,441,209,232
70416,Vladičin Han,3,,741,410,742,331,331,3,328,172,156
70416,Vladičin Han,4,,655,300,655,355,355,3,352,172,180
70416,Vladičin Han,5,,609,307,611,302,302,7,295,120,175
70416,Vladičin Han,6,,753,410,754,343,343,8,335,180,155
70416,Vladičin Han,7,,601,297,601,304,304,3,301,118,183
70416,Vladičin Han,8,,452,206,452,246,246,6,240,88,152
70416,Vladičin Han,9,,709,381,710,328,328,1,327,152,175
70416,Vladičin Han,10,,708,388,708,320,320,6,314,192,122
70416,Vladičin Han,11,,722,542,722,180,180,3,177,109,68
70416,Vladičin Han,12,,506,285,506,221,221,5,216,112,104
70416,Vladičin Han,13,,580,354,578,226,226,5,221,153,68
70416,Vladičin Han,14,,724,383,724,341,341,6,335,180,155
70416,Vladičin Han,15,,607,404,607,203,203,5,198,118,80
70416,Vladičin Han,16,,692,382,694,310,310,4,306,154,152
70416,Vladičin Han,17,,230,128,230,102,102,1,101,44,57
70416,Vladičin Han,18,,220,100,220,120,120,0,120,108,12
70416,Vladičin Han,19,,529,261,529,268,268,0,268,202,66
70416,Vladičin Han,20,,668,437,669,231,231,4,227,124,103
70416,Vladičin Han,21,,320,184,320,136,136,3,133,90,43
70416,Vladičin Han,22,,136,50,136,86,86,0,86,58,28
70416,Vladičin Han,23,,108,81,108,27,27,0,27,22,5
70416,Vladičin Han,24,,151,134,151,17,17,0,17,9,8
70416,Vladičin Han,25,,101,69,101,32,32,2,30,19,11
70416,Vladičin Han,26,,321,185,321,136,136,2,134,72,62
70416,Vladičin Han,27,,141,102,141,39,39,0,39,21,18
70416,Vladičin Han,28,,124,53,124,71,71,0,71,43,28
70416,Vladičin Han,29,,177,122,178,55,55,1,54,40,14
70416,Vladičin Han,30,,320,205,320,115,115,0,115,95,20
70416,Vladičin Han,31,,140,56,140,84,84,0,84,43,41
70416,Vladičin Han,32,,195,135,195,60,60,1,59,22,37
70416,Vladičin Han,33,,190,62,190,128,128,3,125,82,43
70416,Vladičin Han,34,,101,27,101,74,74,0,74,47,27
70416,Vladičin Han,35,,259,150,259,109,109,1,108,66,42
70416,Vladičin Han,36,,124,71,124,53,53,1,52,30,22
70416,Vladičin Han,37,,176,98,176,78,78,3,75,37,38
70416,Vladičin Han,38,,197,84,197,113,113,0,113,57,56
70416,Vladičin Han,39,,252,120,252,132,132,0,132,88,44
70416,Vladičin Han,40,,140,77,140,63,63,0,63,28,35
70416,Vladičin Han,41,,176,85,176,91,91,1,90,67,23
70416,Vladičin Han,42,,237,156,237,81,81,0,81,66,15
70416,Vladičin Han,43,,452,277,452,175,175,3,172,100,72
70416,Vladičin Han,44,,103,81,103,22,22,0,22,14,8
70416,Vladičin Han,45,,101,66,101,35,35,0,35,31,4
70416,Vladičin Han,46,,787,473,787,314,314,1,313,201,112
70416,Vladičin Han,47,,114,77,114,37,37,1,36,21,15
70416,Vladičin Han,48,,181,116,181,65,65,0,65,50,15
70416,Vladičin Han,49,,280,192,281,88,88,1,87,47,40
70416,Vladičin Han,50,,211,121,211,90,90,0,90,45,45
70416,Vladičin Han,51,,113,72,113,41,41,0,41,20,21
70416,Vladičin Han,52,,187,113,187,74,74,0,74,34,40
70416,Vladičin Han,53,,119,61,119,58,58,1,57,40,17
70424,Vlasotince,1,,698,353,698,345,345,5,340,232,108
70424,Vlasotince,2,,606,287,606,319,319,4,315,222,93
70424,Vlasotince,3,,882,489,882,393,393,3,390,263,127
70424,Vlasotince,4,,657,266,657,391,391,2,389,179,210
70424,Vlasotince,5,,813,425,813,388,388,5,383,249,134
70424,Vlasotince,6,,374,155,374,219,219,3,216,95,121
70424,Vlasotince,7,,664,284,664,380,380,17,363,207,156
70424,Vlasotince,8,,362,164,362,198,198,5,193,82,111
70424,Vlasotince,9,,469,217,469,252,252,6,246,119,127
70424,Vlasotince,10,,616,315,616,301,301,3,298,169,129
70424,Vlasotince,11,,840,447,840,393,393,0,393,303,90
70424,Vlasotince,12,,927,572,928,355,355,4,351,252,99
70424,Vlasotince,13,,1159,576,1159,583,583,8,575,403,172
70424,Vlasotince,14,,814,415,814,399,399,8,391,204,187
70424,Vlasotince,15,,951,556,951,395,395,7,388,270,118
70424,Vlasotince,16,,867,490,867,377,377,5,372,265,107
70424,Vlasotince,17,,537,246,537,291,291,0,291,223,68
70424,Vlasotince,18,,149,55,149,94,94,0,94,76,18
70424,Vlasotince,19,,862,433,862,429,429,2,427,314,113
70424,Vlasotince,20,,454,239,454,215,215,3,212,156,56
70424,Vlasotince,21,,258,194,258,64,64,0,64,60,4
70424,Vlasotince,22,,200,120,201,80,80,0,80,70,10
70424,Vlasotince,23,,181,106,181,75,75,3,72,63,9
70424,Vlasotince,24,,413,295,413,118,118,1,117,96,21
70424,Vlasotince,25,,784,403,784,381,381,3,378,314,64
70424,Vlasotince,26,,578,365,578,213,213,0,213,177,36
70424,Vlasotince,27,,626,390,626,236,236,6,230,190,40
70424,Vlasotince,28,,666,292,666,374,374,2,372,300,72
70424,Vlasotince,29,,398,229,398,169,169,2,167,141,26
70424,Vlasotince,30,,519,191,519,328,328,2,326,215,111
70424,Vlasotince,31,,739,373,739,366,366,4,362,272,90
70424,Vlasotince,32,,748,347,748,401,401,3,398,315,83
70424,Vlasotince,33,,408,209,408,199,199,3,196,151,45
70424,Vlasotince,34,,325,166,325,159,159,1,158,130,28
70424,Vlasotince,35,,166,85,166,81,81,3,78,39,39
70424,Vlasotince,36,,197,95,197,102,102,2,100,91,9
70424,Vlasotince,37,,470,301,470,169,169,3,166,153,13
70424,Vlasotince,38,,144,84,144,60,60,0,60,49,11
70424,Vlasotince,39,,290,143,290,147,147,2,145,97,48
70424,Vlasotince,40,,187,126,187,61,61,2,59,47,12
70424,Vlasotince,41,,603,254,603,349,349,5,344,276,68
70424,Vlasotince,42,,145,87,145,58,58,0,58,52,6
70424,Vlasotince,43,,244,151,244,93,93,0,93,75,18
70424,Vlasotince,44,,148,120,148,28,28,0,28,21,7
70424,Vlasotince,45,,161,84,161,77,77,0,77,59,18
70424,Vlasotince,46,,319,213,319,106,106,1,105,84,21
70424,Vlasotince,47,,127,85,127,42,42,1,41,28,13
70424,Vlasotince,48,,100,36,100,64,64,0,64,57,7
70424,Vlasotince,49,,348,181,348,167,167,3,164,126,38
70424,Vlasotince,50,,143,61,141,82,82,0,82,55,27
70424,Vlasotince,51,,165,110,165,55,55,0,55,53,2
70424,Vlasotince,52,,224,145,224,79,79,1,78,63,15
70424,Vlasotince,53,,112,48,112,64,64,1,63,37,26
70424,Vlasotince,54,,162,34,162,128,128,4,124,123,1
70424,Vlasotince,55,,162,93,162,69,69,0,69,64,5
70424,Vlasotince,56,,197,128,197,69,69,2,67,45,22
70424,Vlasotince,57,,264,141,263,123,123,2,121,84,37
70424,Vlasotince,58,,248,188,249,60,60,0,60,40,20
70432,Vranje,1,,1134,582,1136,552,552,12,540,223,317
70432,Vranje,2,,909,437,909,472,472,10,462,244,218
70432,Vranje,3,,1703,860,1703,843,843,24,819,425,394
70432,Vranje,4,,1622,888,1622,734,734,7,727,444,283
70432,Vranje,5,,1573,877,1575,696,695,4,691,411,280
70432,Vranje,6,,1589,898,1589,691,691,6,685,479,206
70432,Vranje,7,,1673,759,1676,914,914,16,898,421,477
70432,Vranje,8,,1743,800,1743,943,943,14,929,492,437
70432,Vranje,9,,1597,868,1599,729,729,11,718,452,266
70432,Vranje,10,,672,341,673,331,331,5,326,206,120
70432,Vranje,11,,133,71,133,62,62,1,61,41,20
70432,Vranje,12,,898,393,897,505,505,7,498,243,255
70432,Vranje,13,,1628,753,1628,875,875,18,857,445,412
70432,Vranje,14,,1570,768,1570,802,802,8,794,467,327
70432,Vranje,15,,1238,640,1237,598,598,13,585,428,157
70432,Vranje,16,,911,435,911,476,476,10,466,173,293
70432,Vranje,17,,1088,529,1088,559,559,11,548,288,260
70432,Vranje,18,,895,534,895,361,361,5,356,179,177
70432,Vranje,19,,1430,652,1431,778,778,11,767,353,414
70432,Vranje,20,,1072,504,1072,568,568,10,558,279,279
70432,Vranje,21,,1323,719,1323,604,604,10,594,369,225
70432,Vranje,22,,1770,833,1771,937,937,12,925,344,581
70432,Vranje,23,,1255,569,1255,686,686,12,674,262,412
70432,Vranje,24,,1526,791,1526,735,735,13,722,331,391
70432,Vranje,25,,1394,943,1395,451,451,4,447,299,148
70432,Vranje,26,,1207,701,1207,506,506,5,501,317,184
70432,Vranje,27,,1547,857,1549,690,690,12,678,371,307
70432,Vranje,28,,1642,884,1641,758,758,5,753,487,266
70432,Vranje,29,,586,347,586,239,239,2,237,174,63
70432,Vranje,30,,174,104,174,70,70,1,69,52,17
70432,Vranje,31,,204,111,204,93,93,2,91,63,28
70432,Vranje,32,,1401,611,1401,790,790,11,779,396,383
70432,Vranje,33,,1096,543,1096,553,553,12,541,267,274
70432,Vranje,34,,1349,668,1351,681,679,7,672,318,354
70432,Vranje,35,,1283,680,1284,603,603,5,598,291,307
70432,Vranje,36,,1813,996,1813,817,817,19,798,435,363
70432,Vranje,37,,1063,571,1063,492,492,3,489,332,157
70432,Vranje,38,,902,489,902,413,413,10,403,283,120
70432,Vranje,39,,304,182,304,122,122,1,121,88,33
70432,Vranje,40,,1175,624,1175,551,551,11,540,260,280
70432,Vranje,41,,482,369,489,113,113,1,112,74,38
70432,Vranje,42,,174,86,174,88,88,1,87,48,39
70432,Vranje,43,,1064,609,1064,455,455,5,450,333,117
70432,Vranje,44,,864,550,864,314,314,8,306,189,117
70432,Vranje,45,,828,426,830,402,402,10,392,297,95
70432,Vranje,46,,229,150,229,79,79,0,79,54,25
70432,Vranje,47,,297,225,297,72,72,0,72,57,15
70432,Vranje,48,,179,127,179,52,52,2,50,27,23
70432,Vranje,49,,140,104,140,36,36,0,36,24,12
70432,Vranje,50,,246,199,246,47,47,0,47,41,6
70432,Vranje,51,,164,108,164,56,56,0,56,54,2
70432,Vranje,52,,468,369,468,99,99,1,98,74,24
70432,Vranje,53,,208,129,209,79,79,1,78,62,16
70432,Vranje,54,,311,203,311,108,108,0,108,84,24
70432,Vranje,55,,353,210,353,143,143,0,143,106,37
70432,Vranje,56,,424,232,425,192,192,1,191,142,49
70432,Vranje,57,,343,199,343,144,144,3,141,81,60
70432,Vranje,58,,138,62,138,76,76,0,76,66,10
70432,Vranje,59,,105,58,105,47,47,1,46,25,21
70432,Vranje,60,,109,33,109,76,76,1,75,53,22
70432,Vranje,61,,109,63,109,46,46,0,46,35,11
70432,Vranje,62,,102,57,102,45,45,1,44,17,27
70432,Vranje,63,,130,70,130,60,60,0,60,49,11
70432,Vranje,64,,157,109,157,48,48,0,48,37,11
70432,Vranje,65,,399,204,399,195,195,1,194,134,60
70432,Vranje,66,,888,493,888,395,395,7,388,250,138
70432,Vranje,67,,774,560,774,214,214,3,211,146,65
70432,Vranje,68,,132,65,132,67,67,0,67,45,22
70432,Vranje,69,,103,64,103,39,39,0,39,11,28
70432,Vranje,70,,120,63,120,57,57,1,56,45,11
70432,Vranje,71,,104,59,104,45,45,0,45,36,9
70432,Vranje,72,,296,208,296,88,88,1,87,68,19
70432,Vranje,73,,133,70,133,63,63,0,63,47,16
70432,Vranje,74,,617,418,617,199,199,4,195,152,43
70432,Vranje,75,,264,168,264,96,96,1,95,78,17
70432,Vranje,76,,479,204,479,275,275,1,274,241,33
70432,Vranje,77,,597,355,598,242,242,0,242,199,43
70432,Vranje,78,,113,56,113,57,57,0,57,49,8
70432,Vranje,79,,122,80,122,42,42,0,42,37,5
70432,Vranje,80,,164,99,164,65,65,0,65,52,13
70432,Vranje,81,,158,122,158,36,36,0,36,28,8
70432,Vranje,82,,722,401,722,321,321,2,319,276,43
70432,Vranje,83,,118,52,118,66,66,0,66,64,2
70432,Vranje,84,,255,154,256,101,101,2,99,90,9
70432,Vranje,85,,360,233,360,127,127,0,127,100,27
70432,Vranje,86,,704,387,704,317,317,7,310,244,66
70432,Vranje,87,,343,195,343,148,148,0,148,126,22
70432,Vranje,88,,614,300,614,314,314,3,311,265,46
70432,Vranje,89,,181,145,181,36,36,1,35,31,4
70432,Vranje,90,,160,127,160,33,33,2,31,17,14
70432,Vranje,91,,124,101,124,23,23,1,22,15,7
70432,Vranje,92,,162,132,162,30,30,2,28,25,3
70432,Vranje,93,,538,309,538,229,229,4,225,142,83
70432,Vranje,94,,459,343,459,116,116,1,115,107,8
70432,Vranje,95,,391,251,391,140,140,3,137,105,32
70432,Vranje,96,,198,96,198,102,102,1,101,85,16
70432,Vranje,97,,270,145,270,125,125,0,125,86,39
70432,Vranje,98,,400,205,400,195,195,1,194,128,66
70432,Vranje,99,,228,170,228,58,58,1,57,48,9
70432,Vranje,100,,904,662,905,242,242,1,241,162,79
70432,Vranje,101,,156,108,156,48,48,0,48,29,19
70432,Vranje,102,,622,362,623,260,260,1,259,190,69
70432,Vranje,103,,458,221,458,237,237,0,237,198,39
70432,Vranje,104,,638,433,638,205,205,3,202,145,57
70432,Vranje,105,,188,111,188,77,77,1,76,50,26
70432,Vranje,106,,140,80,140,60,60,1,59,53,6
70432,Vranje,107,,854,594,854,260,260,1,259,199,60
70459,Vrnjačka Banja,1,,478,291,478,187,187,4,183,96,87
70459,Vrnjačka Banja,2,,728,400,728,328,328,3,325,178,147
70459,Vrnjačka Banja,3,,209,96,209,113,113,0,113,84,29
70459,Vrnjačka Banja,4,,1271,642,1271,629,629,4,625,336,289
70459,Vrnjačka Banja,5,,688,342,688,346,346,8,338,187,151
70459,Vrnjačka Banja,6,,636,276,636,360,360,6,354,171,183
70459,Vrnjačka Banja,7,,801,427,801,374,373,4,369,188,181
70459,Vrnjačka Banja,8,,874,387,874,487,487,11,476,200,276
70459,Vrnjačka Banja,9,,1013,523,1013,490,490,7,483,223,260
70459,Vrnjačka Banja,10,,958,539,958,419,419,2,417,208,209
70459,Vrnjačka Banja,11,,965,472,965,493,493,9,484,229,255
70459,Vrnjačka Banja,12,,930,462,930,468,468,7,461,225,236
70459,Vrnjačka Banja,13,,731,370,731,361,361,8,353,148,205
70459,Vrnjačka Banja,14,,728,392,728,336,336,7,329,207,122
70459,Vrnjačka Banja,15,,631,326,631,305,305,3,302,150,152
70459,Vrnjačka Banja,16,,948,454,948,494,494,9,485,301,184
70459,Vrnjačka Banja,17,,682,377,682,305,305,5,300,168,132
70459,Vrnjačka Banja,18,,290,174,290,116,116,0,116,83,33
70459,Vrnjačka Banja,19,,116,69,116,47,47,0,47,40,7
70459,Vrnjačka Banja,20,,398,205,398,193,193,3,190,120,70
70459,Vrnjačka Banja,21,,323,228,323,95,95,1,94,37,57
70459,Vrnjačka Banja,22,,393,179,393,214,214,4,210,107,103
70459,Vrnjačka Banja,23,,255,129,255,126,126,3,123,74,49
70459,Vrnjačka Banja,24,,207,83,207,124,124,1,123,92,31
70459,Vrnjačka Banja,25,,849,448,849,401,401,1,400,231,169
70459,Vrnjačka Banja,26,,901,514,901,387,387,4,383,218,165
70459,Vrnjačka Banja,27,,479,221,479,258,258,2,256,145,111
70459,Vrnjačka Banja,28,,1288,799,1288,489,489,11,478,348,130
70459,Vrnjačka Banja,29,,417,218,417,199,199,6,193,97,96
70459,Vrnjačka Banja,30,,366,165,366,201,201,1,200,95,105
70459,Vrnjačka Banja,31,,450,205,450,245,245,1,244,180,64
70459,Vrnjačka Banja,32,,622,311,622,311,311,9,302,164,138
70459,Vrnjačka Banja,33,,627,337,627,290,290,2,288,167,121
70459,Vrnjačka Banja,34,,325,98,325,227,227,1,226,155,71
70459,Vrnjačka Banja,35,,1361,744,1361,617,617,14,603,360,243
70459,Vrnjačka Banja,36,,693,404,693,289,289,9,280,155,125
70459,Vrnjačka Banja,37,,607,268,607,339,339,3,336,220,116
70459,Vrnjačka Banja,38,,357,182,355,175,174,0,174,119,55
70467,Gaxin Han,1,,360,257,360,103,103,4,99,59,40
70467,Gaxin Han,2,,540,340,540,200,200,2,198,100,98
70467,Gaxin Han,3,,361,222,361,139,139,2,137,77,60
70467,Gaxin Han,4,,323,171,323,152,152,4,148,92,56
70467,Gaxin Han,5,,161,81,161,80,80,0,80,55,25
70467,Gaxin Han,6,,319,194,319,125,125,1,124,88,36
70467,Gaxin Han,7,,296,201,296,95,95,0,95,61,34
70467,Gaxin Han,8,,381,219,381,162,162,3,159,127,32
70467,Gaxin Han,9,,131,66,131,65,65,2,63,45,18
70467,Gaxin Han,10,,209,69,209,140,140,2,138,82,56
70467,Gaxin Han,11,,469,239,469,230,230,4,226,150,76
70467,Gaxin Han,12,,322,171,322,151,151,1,150,123,27
70467,Gaxin Han,13,,163,72,163,91,91,2,89,71,18
70467,Gaxin Han,14,,300,137,300,163,163,4,159,123,36
70467,Gaxin Han,15,,179,59,179,120,120,1,119,94,25
70467,Gaxin Han,16,,105,62,105,43,43,1,42,24,18
70467,Gaxin Han,17,,170,97,170,73,73,2,71,57,14
70467,Gaxin Han,18,,284,166,284,118,118,1,117,63,54
70467,Gaxin Han,19,,236,153,237,83,83,1,82,53,29
70467,Gaxin Han,20,,202,94,202,108,108,3,105,78,27
70467,Gaxin Han,21,,189,99,189,90,90,1,89,58,31
70467,Gaxin Han,22,,339,224,339,115,115,2,113,88,25
70467,Gaxin Han,23,,135,54,135,81,81,1,80,49,31
70467,Gaxin Han,24,,283,143,283,140,140,3,137,98,39
70467,Gaxin Han,25,,222,151,222,71,71,2,69,54,15
70467,Gaxin Han,26,,238,144,238,94,94,4,90,58,32
70467,Gaxin Han,27,,251,159,251,92,92,1,91,71,20
70467,Gaxin Han,28,,385,201,385,184,184,3,181,160,21
70467,Gaxin Han,29,,280,218,280,62,62,0,62,43,19
70467,Gaxin Han,30,,287,196,287,91,91,3,88,74,14
70467,Gaxin Han,31,,135,78,135,57,57,2,55,44,11
70467,Gaxin Han,32,,271,169,271,102,102,0,102,77,25
70467,Gaxin Han,33,,177,92,176,85,85,2,83,49,34
70467,Gaxin Han,34,,233,161,233,72,72,0,72,54,18
70467,Gaxin Han,35,,252,167,252,85,85,6,79,41,38
70475,Golubac,1,,485,240,485,245,245,11,234,101,133
70475,Golubac,2,,396,157,396,239,239,4,235,98,137
70475,Golubac,3,,404,194,404,210,210,0,210,126,84
70475,Golubac,4,,394,156,394,238,238,4,234,115,119
70475,Golubac,5,,276,154,276,122,122,1,121,73,48
70475,Golubac,6,,291,135,291,156,156,5,151,79,72
70475,Golubac,7,,356,159,356,197,197,5,192,113,79
70475,Golubac,8,,242,116,242,126,126,5,121,70,51
70475,Golubac,9,,183,84,183,99,99,1,98,59,39
70475,Golubac,10,,243,109,243,134,134,3,131,52,79
70475,Golubac,11,,198,131,198,67,67,3,64,23,41
70475,Golubac,12,,269,155,269,114,114,6,108,36,72
70475,Golubac,13,,265,145,265,120,120,1,119,68,51
70475,Golubac,14,,281,133,281,148,148,2,146,100,46
70475,Golubac,15,,382,240,382,142,142,7,135,77,58
70475,Golubac,16,,474,281,474,193,193,3,190,122,68
70475,Golubac,17,,317,171,317,146,146,5,141,60,81
70475,Golubac,18,,319,129,319,190,190,4,186,112,74
70475,Golubac,19,,466,242,466,224,224,1,223,147,76
70475,Golubac,20,,239,93,239,146,146,1,145,76,69
70475,Golubac,21,,281,164,281,117,117,2,115,65,50
70475,Golubac,22,,287,163,287,124,124,1,123,71,52
70475,Golubac,23,,495,197,495,298,298,4,294,151,143
70475,Golubac,24,,405,142,405,263,263,3,260,102,158
70475,Golubac,25,,312,107,312,205,205,0,205,78,127
70475,Golubac,26,,293,152,293,141,141,2,139,88,51
70475,Golubac,27,,328,186,328,142,142,2,140,90,50
70475,Golubac,28,,241,112,241,129,129,4,125,44,81
70475,Golubac,29,,241,105,241,136,136,4,132,62,70
70475,Golubac,30,,150,71,150,79,79,1,78,41,37
70483,Gornji Milanovac,1,,583,354,583,229,229,3,226,113,113
70483,Gornji Milanovac,2,,254,129,254,125,125,0,125,79,46
70483,Gornji Milanovac,3,,622,381,622,241,241,1,240,107,133
70483,Gornji Milanovac,4,,183,77,183,106,106,2,104,68,36
70483,Gornji Milanovac,5,,802,370,802,432,432,4,428,215,213
70483,Gornji Milanovac,6,,356,219,356,137,137,1,136,48,88
70483,Gornji Milanovac,7,,518,291,518,227,227,2,225,83,142
70483,Gornji Milanovac,8,,620,372,620,248,248,2,246,105,141
70483,Gornji Milanovac,9,,319,195,319,124,124,4,120,57,63
70483,Gornji Milanovac,10,,234,150,234,84,84,1,83,32,51
70483,Gornji Milanovac,11,,201,91,201,110,110,1,109,45,64
70483,Gornji Milanovac,12,,135,54,135,81,81,1,80,44,36
70483,Gornji Milanovac,13,,169,93,169,76,76,1,75,31,44
70483,Gornji Milanovac,14,,267,98,267,169,169,2,167,95,72
70483,Gornji Milanovac,15,,318,116,318,202,202,1,201,87,114
70483,Gornji Milanovac,16,,414,191,414,223,223,3,220,93,127
70483,Gornji Milanovac,17,,506,345,506,161,161,2,159,92,67
70483,Gornji Milanovac,18,,215,107,215,108,108,2,106,65,41
70483,Gornji Milanovac,19,,493,225,493,268,268,5,263,123,140
70483,Gornji Milanovac,20,,268,120,268,148,148,5,143,69,74
70483,Gornji Milanovac,21,,117,43,117,74,74,2,72,39,33
70483,Gornji Milanovac,22,,958,419,958,539,539,7,532,233,299
70483,Gornji Milanovac,23,,416,217,416,199,199,4,195,98,97
70483,Gornji Milanovac,24,,121,55,121,66,66,1,65,44,21
70483,Gornji Milanovac,25,,335,208,335,127,127,0,127,46,81
70483,Gornji Milanovac,26,,146,50,146,96,96,3,93,42,51
70483,Gornji Milanovac,27,,203,112,203,91,91,1,90,47,43
70483,Gornji Milanovac,28,,250,139,250,111,111,6,105,61,44
70483,Gornji Milanovac,29,,302,156,302,146,146,1,145,86,59
70483,Gornji Milanovac,30,,107,39,107,68,68,1,67,33,34
70483,Gornji Milanovac,31,,297,148,297,149,149,4,145,65,80
70483,Gornji Milanovac,32,,400,204,400,196,196,6,190,89,101
70483,Gornji Milanovac,33,,618,326,618,292,292,10,282,130,152
70483,Gornji Milanovac,34,,267,156,267,111,111,2,109,55,54
70483,Gornji Milanovac,35,,341,174,341,167,167,3,164,83,81
70483,Gornji Milanovac,36,,126,47,126,79,79,0,79,42,37
70483,Gornji Milanovac,37,,1558,696,1558,862,860,22,838,374,464
70483,Gornji Milanovac,38,,504,285,504,219,219,4,215,110,105
70483,Gornji Milanovac,39,,394,236,394,158,158,0,158,64,94
70483,Gornji Milanovac,40,,1275,758,1275,517,517,6,511,293,218
70483,Gornji Milanovac,41,,1053,496,1053,557,557,7,550,259,291
70483,Gornji Milanovac,42,,711,405,711,306,306,6,300,148,152
70483,Gornji Milanovac,43,,295,150,295,145,145,3,142,55,87
70483,Gornji Milanovac,44,,632,376,632,256,256,7,249,120,129
70483,Gornji Milanovac,45,,903,514,903,389,389,5,384,164,220
70483,Gornji Milanovac,46,,1118,629,1118,489,489,3,486,211,275
70483,Gornji Milanovac,47,,510,241,510,269,269,14,255,119,136
70483,Gornji Milanovac,48,,132,41,132,91,91,1,90,53,37
70483,Gornji Milanovac,49,,207,93,207,114,114,0,114,61,53
70483,Gornji Milanovac,50,,238,136,238,102,102,2,100,63,37
70483,Gornji Milanovac,51,,212,108,212,104,104,0,104,54,50
70483,Gornji Milanovac,52,,270,133,270,137,137,3,134,58,76
70483,Gornji Milanovac,53,,205,130,205,75,75,3,72,51,21
70483,Gornji Milanovac,54,,1853,802,1853,1051,1051,20,1031,362,669
70483,Gornji Milanovac,55,,1624,750,1624,874,874,16,858,301,557
70483,Gornji Milanovac,56,,1745,918,1745,827,827,12,815,310,505
70483,Gornji Milanovac,57,,1231,539,1231,692,692,13,679,218,461
70483,Gornji Milanovac,58,,1119,469,1119,650,649,13,636,264,372
70483,Gornji Milanovac,59,,1053,442,1053,611,611,13,598,235,363
70483,Gornji Milanovac,60,,1565,697,1565,868,868,28,840,334,506
70483,Gornji Milanovac,61,,1189,553,1189,636,636,12,624,249,375
70483,Gornji Milanovac,62,,560,324,560,236,236,5,231,90,141
70483,Gornji Milanovac,63,,1376,696,1376,680,680,6,674,319,355
70483,Gornji Milanovac,64,,1092,527,1092,565,565,10,555,266,289
70483,Gornji Milanovac,65,,1108,459,1108,649,649,20,629,221,408
70483,Gornji Milanovac,66,,1219,584,1219,635,635,10,625,232,393
70483,Gornji Milanovac,67,,969,446,969,523,523,14,509,187,322
70491,Despotovac,1,,478,321,478,157,157,3,154,64,90
70491,Despotovac,2,,399,288,399,111,111,0,111,67,44
70491,Despotovac,3,,538,303,538,235,235,9,226,157,69
70491,Despotovac,4,,440,267,440,173,173,2,171,55,116
70491,Despotovac,5,,548,346,548,202,202,1,201,114,87
70491,Despotovac,6,,745,439,745,306,306,10,296,134,162
70491,Despotovac,7,,678,402,678,276,276,4,272,109,163
70491,Despotovac,8,,926,507,926,419,419,15,404,217,187
70491,Despotovac,9,,655,466,655,189,189,1,188,56,132
70491,Despotovac,10,,445,257,445,188,188,3,185,55,130
70491,Despotovac,11,,551,301,551,250,250,11,239,159,80
70491,Despotovac,12,,900,506,901,394,394,5,389,189,200
70491,Despotovac,13,,632,328,632,304,304,7,297,170,127
70491,Despotovac,14,,655,338,656,317,317,8,309,148,161
70491,Despotovac,15,,563,283,563,280,280,5,275,131,144
70491,Despotovac,16,,696,383,697,313,313,6,307,148,159
70491,Despotovac,17,,742,431,742,311,311,5,306,163,143
70491,Despotovac,18,,683,510,683,173,173,3,170,74,96
70491,Despotovac,19,,651,501,651,150,150,8,142,85,57
70491,Despotovac,20,,376,248,376,128,128,4,124,62,62
70491,Despotovac,21,,489,300,489,189,189,2,187,110,77
70491,Despotovac,22,,520,322,520,198,198,2,196,139,57
70491,Despotovac,23,,514,359,514,155,155,1,154,95,59
70491,Despotovac,24,,593,405,593,188,188,3,185,126,59
70491,Despotovac,25,,544,323,544,221,221,10,211,117,94
70491,Despotovac,26,,506,306,506,200,200,5,195,92,103
70491,Despotovac,27,,578,300,578,278,278,5,273,158,115
70491,Despotovac,28,,501,251,501,250,250,2,248,166,82
70491,Despotovac,29,,532,316,532,216,216,6,210,111,99
70491,Despotovac,30,,484,282,484,202,202,6,196,115,81
70491,Despotovac,31,,539,294,539,245,245,6,239,172,67
70491,Despotovac,32,,578,327,578,251,251,6,245,166,79
70491,Despotovac,33,,313,183,313,130,130,2,128,88,40
70491,Despotovac,34,,364,223,364,141,141,2,139,101,38
70491,Despotovac,35,,720,352,720,368,368,3,365,236,129
70491,Despotovac,36,,721,272,721,449,449,2,447,283,164
70491,Despotovac,37,,692,354,692,338,338,6,332,222,110
70491,Despotovac,38,,964,578,963,386,386,4,382,208,174
70491,Despotovac,39,,155,99,155,56,56,0,56,31,25
70491,Despotovac,40,,703,467,703,236,236,3,233,133,100
70491,Despotovac,41,,515,253,515,262,262,9,253,153,100
70491,Despotovac,42,,793,473,793,320,320,5,315,176,139
70491,Despotovac,43,,653,332,653,321,321,4,317,171,146
70491,Despotovac,44,,386,223,386,163,163,3,160,111,49
70505,Dimitrovgrad,1,,1255,660,1255,595,595,13,582,220,362
70505,Dimitrovgrad,2,,1777,953,1777,824,824,14,810,309,501
70505,Dimitrovgrad,3,,1557,743,1557,814,814,14,800,250,550
70505,Dimitrovgrad,4,,1320,700,1320,620,620,25,595,181,414
70505,Dimitrovgrad,5,,351,159,351,192,192,8,184,81,103
70505,Dimitrovgrad,6,,1183,610,1183,573,573,7,566,332,234
70505,Dimitrovgrad,7,,676,358,676,318,318,5,313,176,137
70505,Dimitrovgrad,8,,233,130,233,103,103,4,99,47,52
70505,Dimitrovgrad,9,,192,86,192,106,106,4,102,36,66
70505,Dimitrovgrad,10,,138,91,138,47,47,1,46,31,15
70505,Dimitrovgrad,11,,183,121,183,62,62,1,61,29,32
70505,Dimitrovgrad,12,,182,137,182,45,45,1,44,22,22
70505,Dimitrovgrad,13,,139,103,139,36,36,0,36,15,21
70505,Dimitrovgrad,14,,164,72,164,92,92,5,87,45,42
70505,Dimitrovgrad,15,,240,137,240,103,103,4,99,19,80
70505,Dimitrovgrad,16,,160,97,160,63,63,0,63,26,37
70505,Dimitrovgrad,17,,151,125,151,26,26,0,26,22,4
70513,Doljevac,1,,525,279,525,246,246,1,245,171,74
70513,Doljevac,2,,478,208,478,270,270,3,267,166,101
70513,Doljevac,3,,572,263,572,309,309,10,299,189,110
70513,Doljevac,4,,400,179,400,221,221,5,216,84,132
70513,Doljevac,5,,367,166,367,201,201,2,199,111,88
70513,Doljevac,6,,150,24,150,126,126,1,125,100,25
70513,Doljevac,7,,419,180,419,239,239,0,239,164,75
70513,Doljevac,8,,441,201,441,240,240,5,235,114,121
70513,Doljevac,9,,336,161,336,175,175,4,171,97,74
70513,Doljevac,10,,391,204,391,187,187,3,184,122,62
70513,Doljevac,11,,432,227,432,205,205,0,205,123,82
70513,Doljevac,12,,458,210,458,248,248,1,247,138,109
70513,Doljevac,13,,356,147,356,209,209,4,205,108,97
70513,Doljevac,14,,494,238,494,256,256,6,250,140,110
70513,Doljevac,15,,513,276,513,237,237,1,236,126,110
70513,Doljevac,16,,383,164,383,219,219,2,217,161,56
70513,Doljevac,17,,432,189,432,243,243,2,241,185,56
70513,Doljevac,18,,387,207,387,180,180,1,179,141,38
70513,Doljevac,19,,419,201,419,218,218,6,212,107,105
70513,Doljevac,20,,428,196,428,232,232,5,227,163,64
70513,Doljevac,21,,165,76,165,89,89,0,89,70,19
70513,Doljevac,22,,549,264,549,285,285,3,282,173,109
70513,Doljevac,23,,584,256,584,328,328,7,321,207,114
70513,Doljevac,24,,595,305,595,290,290,3,287,174,113
70513,Doljevac,25,,392,198,392,194,194,5,189,100,89
70513,Doljevac,26,,420,226,420,194,194,1,193,130,63
70513,Doljevac,27,,601,331,601,270,270,2,268,172,96
70513,Doljevac,28,,413,168,413,245,245,3,242,158,84
70513,Doljevac,29,,121,60,121,61,61,0,61,40,21
70513,Doljevac,30,,360,177,360,183,183,6,177,127,50
70513,Doljevac,31,,382,173,382,209,209,4,205,123,82
70513,Doljevac,32,,365,156,365,209,209,2,207,142,65
70513,Doljevac,33,,291,126,291,165,165,4,161,123,38
70513,Doljevac,34,,364,169,364,195,195,0,195,128,67
70513,Doljevac,35,,386,178,386,208,208,4,204,135,69
70513,Doljevac,36,,361,172,361,189,189,2,187,127,60
70513,Doljevac,37,,324,137,324,187,187,0,187,90,97
70521,Žabari,1,,338,197,338,141,141,5,136,78,58
70521,Žabari,2,,343,163,343,180,180,5,175,91,84
70521,Žabari,3,,370,222,370,148,148,2,146,83,63
70521,Žabari,4,,321,195,321,126,126,0,126,73,53
70521,Žabari,5,,504,301,504,203,203,4,199,90,109
70521,Žabari,6,,377,207,377,170,170,4,166,61,105
70521,Žabari,7,,488,318,488,170,170,4,166,112,54
70521,Žabari,8,,347,262,347,85,85,0,85,46,39
70521,Žabari,9,,189,105,189,84,84,2,82,65,17
70521,Žabari,10,,531,374,531,157,157,2,155,83,72
70521,Žabari,11,,476,317,476,159,159,0,159,71,88
70521,Žabari,12,,438,290,438,148,148,2,146,53,93
70521,Žabari,13,,359,294,359,65,65,1,64,19,45
70521,Žabari,14,,355,167,355,188,188,4,184,75,109
70521,Žabari,15,,399,180,399,219,219,3,216,114,102
70521,Žabari,16,,221,128,221,93,93,3,90,46,44
70521,Žabari,17,,280,149,281,131,131,5,126,56,70
70521,Žabari,18,,430,269,430,161,161,0,161,108,53
70521,Žabari,19,,365,251,365,114,114,2,112,51,61
70521,Žabari,20,,264,173,264,91,91,1,90,52,38
70521,Žabari,21,,309,178,309,131,131,2,129,62,67
70521,Žabari,22,,420,241,420,179,179,2,177,62,115
70521,Žabari,23,,271,128,271,143,143,1,142,93,49
70521,Žabari,24,,228,102,228,126,126,0,126,51,75
70521,Žabari,25,,369,217,369,152,152,0,152,93,59
70521,Žabari,26,,553,354,553,199,199,5,194,95,99
70521,Žabari,27,,515,326,515,189,189,4,185,113,72
70521,Žabari,28,,727,450,727,277,277,5,272,151,121
70521,Žabari,29,,274,168,274,106,106,0,106,48,58
70521,Žabari,30,,400,208,400,192,192,4,188,114,74
70521,Žabari,31,,362,167,362,195,195,5,190,107,83
70521,Žabari,32,,312,145,312,167,167,1,166,97,69
70521,Žabari,33,,409,237,409,172,172,1,171,89,82
70521,Žabari,34,,307,185,307,122,122,4,118,88,30
70521,Žabari,35,,388,280,388,108,108,4,104,42,62
70521,Žabari,36,,313,155,313,158,158,8,150,53,97
70521,Žabari,37,,304,196,304,108,108,0,108,43,65
70530,Žagubica,1,,404,208,404,196,196,5,191,78,113
70530,Žagubica,2,,321,122,321,199,199,8,191,79,112
70530,Žagubica,3,,350,179,350,171,171,1,170,66,104
70530,Žagubica,4,,251,175,251,76,76,4,72,35,37
70530,Žagubica,5,,524,315,524,209,209,5,204,107,97
70530,Žagubica,6,,481,309,481,172,172,4,168,92,76
70530,Žagubica,7,,221,157,221,64,64,1,63,46,17
70530,Žagubica,8,,337,222,337,115,115,4,111,61,50
70530,Žagubica,9,,281,183,281,98,98,0,98,43,55
70530,Žagubica,10,,392,269,392,123,123,4,119,65,54
70530,Žagubica,11,,517,375,517,142,142,6,136,68,68
70530,Žagubica,12,,419,255,419,164,164,0,164,113,51
70530,Žagubica,13,,666,351,666,315,315,4,311,166,145
70530,Žagubica,14,,406,164,406,242,242,4,238,144,94
70530,Žagubica,15,,541,357,541,184,184,0,184,98,86
70530,Žagubica,16,,403,262,403,141,141,6,135,91,44
70530,Žagubica,17,,284,169,284,115,115,0,115,52,63
70530,Žagubica,18,,325,212,325,113,113,1,112,60,52
70530,Žagubica,19,,404,209,404,195,195,6,189,112,77
70530,Žagubica,20,,299,132,299,167,167,2,165,118,47
70530,Žagubica,21,,407,214,407,193,193,4,189,125,64
70530,Žagubica,22,,319,163,319,156,156,3,153,70,83
70530,Žagubica,23,,435,214,435,221,221,5,216,109,107
70530,Žagubica,24,,398,216,398,182,182,4,178,112,66
70530,Žagubica,25,,372,196,372,176,176,3,173,84,89
70530,Žagubica,26,,381,237,381,144,144,3,141,74,67
70530,Žagubica,27,,356,210,356,146,146,2,144,76,68
70530,Žagubica,28,,188,122,188,66,66,1,65,41,24
70530,Žagubica,29,,385,280,385,105,105,4,101,51,50
70530,Žagubica,30,,355,231,355,124,124,3,121,70,51
70530,Žagubica,31,,460,290,460,170,170,5,165,105,60
70530,Žagubica,32,,591,377,591,214,214,0,214,177,37
70530,Žagubica,33,,365,235,365,130,130,0,130,84,46
70548,Žitorađa,1,,324,169,324,155,155,3,152,83,69
70548,Žitorađa,2,,316,153,316,163,163,0,163,121,42
70548,Žitorađa,3,,412,222,412,190,190,0,190,107,83
70548,Žitorađa,4,,383,205,383,178,178,0,178,118,60
70548,Žitorađa,5,,322,175,322,147,147,4,143,85,58
70548,Žitorađa,6,,338,195,338,143,143,2,141,86,55
70548,Žitorađa,7,,318,153,318,165,165,1,164,126,38
70548,Žitorađa,8,,312,141,312,171,171,1,170,112,58
70548,Žitorađa,9,,215,82,215,133,133,1,132,87,45
70548,Žitorađa,10,,420,187,420,233,233,4,229,129,100
70548,Žitorađa,11,,331,133,331,198,198,2,196,131,65
70548,Žitorađa,12,,348,181,348,167,167,0,167,131,36
70548,Žitorađa,13,,398,171,398,227,227,1,226,200,26
70548,Žitorađa,14,,335,205,335,130,130,4,126,101,25
70548,Žitorađa,15,,266,194,266,72,72,1,71,60,11
70548,Žitorađa,16,,386,161,386,225,225,1,224,204,20
70548,Žitorađa,17,,312,174,312,138,138,1,137,113,24
70548,Žitorađa,18,,471,240,471,231,231,1,230,129,101
70548,Žitorađa,19,,366,177,366,189,189,3,186,92,94
70548,Žitorađa,20,,373,203,373,170,170,2,168,81,87
70548,Žitorađa,21,,392,213,392,179,179,4,175,109,66
70548,Žitorađa,22,,667,326,667,341,341,8,333,175,158
70548,Žitorađa,23,,502,273,502,229,229,4,225,90,135
70548,Žitorađa,24,,402,248,402,154,154,5,149,104,45
70548,Žitorađa,25,,371,206,371,165,165,6,159,102,57
70548,Žitorađa,26,,166,95,166,71,71,1,70,52,18
70548,Žitorađa,27,,399,244,399,155,155,3,152,117,35
70548,Žitorađa,28,,367,228,367,139,139,2,137,115,22
70548,Žitorađa,29,,371,174,371,197,197,0,197,166,31
70548,Žitorađa,30,,342,198,342,144,144,1,143,126,17
70548,Žitorađa,31,,271,125,271,146,146,1,145,115,30
70548,Žitorađa,32,,619,284,619,335,335,13,322,187,135
70548,Žitorađa,33,,655,428,655,227,227,6,221,143,78
70548,Žitorađa,34,,576,318,576,258,258,1,257,184,73
70548,Žitorađa,35,,342,177,342,165,165,5,160,65,95
70548,Žitorađa,36,,274,182,274,92,92,3,89,54,35
70548,Žitorađa,37,,189,65,189,124,123,1,122,119,3
70548,Žitorađa,38,,245,156,245,89,89,0,89,67,22
70548,Žitorađa,39,,262,173,262,89,89,0,89,53,36
70556,Zaječar,1,,1439,801,1439,638,638,9,629,297,332
70556,Zaječar,2,,1701,935,1701,766,766,17,749,318,431
70556,Zaječar,3,,1436,806,1438,630,630,10,620,306,314
70556,Zaječar,4,,1521,779,1521,742,742,12,730,312,418
70556,Zaječar,5,,1237,596,1237,641,641,9,632,204,428
70556,Zaječar,6,,1297,659,1297,638,638,6,632,213,419
70556,Zaječar,7,,1275,567,1275,708,708,11,697,252,445
70556,Zaječar,8,,1176,558,1176,618,618,5,613,205,408
70556,Zaječar,9,,1028,438,1028,590,590,2,588,193,395
70556,Zaječar,10,,1605,783,1605,822,822,11,811,266,545
70556,Zaječar,11,,1407,688,1407,719,719,14,705,269,436
70556,Zaječar,12,,1044,530,1044,514,514,10,504,185,319
70556,Zaječar,13,,1269,639,1269,630,630,14,616,264,352
70556,Zaječar,14,,1432,809,1432,623,623,12,611,259,352
70556,Zaječar,15,,1272,589,1272,683,683,5,678,320,358
70556,Zaječar,16,,1715,921,1716,794,794,20,774,411,363
70556,Zaječar,17,,1881,1049,1882,832,832,6,826,455,371
70556,Zaječar,18,,1127,528,1127,599,599,13,586,237,349
70556,Zaječar,19,,1193,625,1193,568,568,12,556,229,327
70556,Zaječar,20,,1734,975,1734,759,759,7,752,368,384
70556,Zaječar,21,,1396,736,1396,660,660,13,647,356,291
70556,Zaječar,22,,1263,650,1263,613,613,4,609,356,253
70556,Zaječar,23,,1125,608,1125,517,517,14,503,238,265
70556,Zaječar,24,,1442,839,1443,603,603,8,595,365,230
70556,Zaječar,25,,1523,773,1523,750,749,11,738,374,364
70556,Zaječar,26,,2093,1045,2093,1048,1048,23,1025,412,613
70556,Zaječar,27,,886,397,886,489,489,13,476,258,218
70556,Zaječar,28,,1018,557,1018,461,461,9,452,284,168
70556,Zaječar,29,,787,498,787,289,289,4,285,159,126
70556,Zaječar,30,,339,173,339,166,166,2,164,105,59
70556,Zaječar,31,,621,328,621,293,293,1,292,151,141
70556,Zaječar,32,,221,112,221,109,109,1,108,71,37
70556,Zaječar,33,,461,244,461,217,217,7,210,146,64
70556,Zaječar,34,,682,400,682,282,282,4,278,132,146
70556,Zaječar,35,,1235,718,1235,517,517,8,509,286,223
70556,Zaječar,36,,565,316,565,249,249,11,238,124,114
70556,Zaječar,37,,463,295,463,168,168,4,164,81,83
70556,Zaječar,38,,404,224,404,180,180,4,176,95,81
70556,Zaječar,39,,389,167,389,222,222,4,218,116,102
70556,Zaječar,40,,307,115,307,192,192,1,191,126,65
70556,Zaječar,41,,230,98,230,132,132,1,131,75,56
70556,Zaječar,42,,142,77,142,65,65,2,63,45,18
70556,Zaječar,43,,408,244,408,164,164,2,162,60,102
70556,Zaječar,44,,416,286,417,130,130,2,128,54,74
70556,Zaječar,45,,228,135,228,93,93,1,92,37,55
70556,Zaječar,46,,388,203,388,185,185,0,185,95,90
70556,Zaječar,47,,215,117,215,98,98,1,97,52,45
70556,Zaječar,48,,183,79,183,104,104,3,101,68,33
70556,Zaječar,49,,846,478,846,368,368,8,360,208,152
70556,Zaječar,50,,303,175,303,128,128,2,126,74,52
70556,Zaječar,51,,902,550,902,352,352,5,347,124,223
70556,Zaječar,52,,472,262,472,210,210,2,208,139,69
70556,Zaječar,53,,179,94,179,85,85,0,85,58,27
70556,Zaječar,54,,197,93,197,104,104,1,103,64,39
70556,Zaječar,55,,152,92,152,60,60,0,60,26,34
70556,Zaječar,56,,330,189,330,141,141,6,135,86,49
70556,Zaječar,57,,222,111,222,111,111,0,111,68,43
70556,Zaječar,58,,252,152,252,100,100,6,94,42,52
70556,Zaječar,59,,273,163,273,110,110,1,109,55,54
70556,Zaječar,60,,311,161,311,150,150,0,150,75,75
70556,Zaječar,61,,197,90,197,107,107,1,106,35,71
70556,Zaječar,62,,276,171,275,105,105,1,104,52,52
70556,Zaječar,63,,720,419,720,301,301,7,294,165,129
70556,Zaječar,64,,987,708,986,279,279,7,272,149,123
70556,Zaječar,65,,275,167,274,108,108,1,107,53,54
70556,Zaječar,66,,569,303,569,266,266,1,265,113,152
70556,Zaječar,67,,194,76,194,118,118,1,117,79,38
70556,Zaječar,68,,1177,606,1178,571,571,14,557,294,263
70556,Zaječar,69,,638,388,638,250,250,2,248,166,82
70556,Zaječar,70,,803,426,803,377,377,3,374,197,177
70556,Zaječar,71,,581,326,581,255,255,2,253,87,166
70556,Zaječar,72,,477,267,477,210,210,4,206,97,109
70556,Zaječar,73,,177,96,177,81,81,0,81,59,22
70556,Zaječar,74,,100,51,100,49,49,1,48,32,16
70564,Ivanjica,1,,1438,753,1438,685,685,11,674,304,370
70564,Ivanjica,2,,1317,591,1317,726,726,12,714,247,467
70564,Ivanjica,3,,746,325,746,421,421,6,415,205,210
70564,Ivanjica,4,,868,431,868,437,437,11,426,164,262
70564,Ivanjica,5,,1384,633,1384,751,751,14,737,273,464
70564,Ivanjica,6,,1530,735,1530,795,795,6,789,210,579
70564,Ivanjica,7,,1762,937,1762,825,823,8,815,433,382
70564,Ivanjica,8,,1645,842,1645,803,803,4,799,434,365
70564,Ivanjica,9,,263,121,263,142,142,4,138,79,59
70564,Ivanjica,10,,228,160,228,68,68,0,68,41,27
70564,Ivanjica,11,,561,330,561,231,231,2,229,128,101
70564,Ivanjica,12,,140,86,140,54,54,1,53,40,13
70564,Ivanjica,13,,266,169,266,97,97,2,95,55,40
70564,Ivanjica,14,,261,135,261,126,126,2,124,92,32
70564,Ivanjica,15,,137,81,137,56,56,0,56,36,20
70564,Ivanjica,16,,108,69,108,39,39,1,38,26,12
70564,Ivanjica,17,,295,231,295,64,64,1,63,26,37
70564,Ivanjica,18,,209,123,209,86,86,0,86,45,41
70564,Ivanjica,19,,173,114,173,59,59,1,58,49,9
70564,Ivanjica,20,,137,76,137,61,61,1,60,36,24
70564,Ivanjica,21,,169,106,169,63,63,0,63,32,31
70564,Ivanjica,22,,157,127,157,30,30,0,30,22,8
70564,Ivanjica,23,,1018,539,1018,479,479,9,470,208,262
70564,Ivanjica,24,,1060,643,1060,417,417,5,412,167,245
70564,Ivanjica,25,,442,296,442,146,146,1,145,62,83
70564,Ivanjica,26,,569,335,569,234,234,0,234,174,60
70564,Ivanjica,27,,185,132,185,53,53,0,53,37,16
70564,Ivanjica,28,,124,65,124,59,59,0,59,28,31
70564,Ivanjica,29,,243,136,243,107,107,1,106,36,70
70564,Ivanjica,30,,199,124,199,75,75,0,75,60,15
70564,Ivanjica,31,,669,413,669,256,256,4,252,143,109
70564,Ivanjica,32,,213,169,213,44,44,0,44,27,17
70564,Ivanjica,33,,135,84,135,51,51,0,51,46,5
70564,Ivanjica,34,,728,471,728,257,257,2,255,118,137
70564,Ivanjica,35,,648,455,648,193,193,2,191,72,119
70564,Ivanjica,36,,271,167,271,104,104,0,104,62,42
70564,Ivanjica,37,,528,292,528,236,236,6,230,133,97
70564,Ivanjica,38,,168,106,168,62,62,0,62,43,19
70564,Ivanjica,39,,209,164,209,45,45,0,45,29,16
70564,Ivanjica,40,,185,85,185,100,100,1,99,67,32
70564,Ivanjica,41,,196,123,196,73,73,0,73,41,32
70564,Ivanjica,42,,661,498,661,163,163,5,158,112,46
70564,Ivanjica,43,,389,251,389,138,138,5,133,96,37
70564,Ivanjica,44,,121,90,121,31,31,0,31,20,11
70564,Ivanjica,45,,827,563,827,264,264,6,258,134,124
70564,Ivanjica,46,,356,250,356,106,106,1,105,69,36
70564,Ivanjica,47,,337,191,337,146,146,0,146,97,49
70564,Ivanjica,48,,1125,667,1125,458,458,1,457,203,254
70564,Ivanjica,49,,175,91,175,84,84,0,84,60,24
70564,Ivanjica,50,,600,379,600,221,221,2,219,102,117
70564,Ivanjica,51,,191,118,191,73,73,0,73,47,26
70564,Ivanjica,52,,1159,727,1159,432,432,3,429,230,199
70564,Ivanjica,53,,148,111,148,37,37,0,37,22,15
70564,Ivanjica,54,,274,160,274,114,114,0,114,84,30
70564,Ivanjica,55,,181,129,181,52,52,0,52,42,10
70564,Ivanjica,56,,136,77,136,59,59,0,59,32,27
70564,Ivanjica,57,,329,261,329,68,68,0,68,56,12
70572,Kladovo,1,,1103,575,1103,528,528,10,518,208,310
70572,Kladovo,2,,520,225,520,295,295,5,290,162,128
70572,Kladovo,3,,566,291,566,275,275,1,274,82,192
70572,Kladovo,4,,816,370,816,446,446,10,436,199,237
70572,Kladovo,5,,1448,628,1448,820,820,14,806,252,554
70572,Kladovo,6,,1055,586,1055,469,469,11,458,216,242
70572,Kladovo,7,,879,426,879,453,453,8,445,180,265
70572,Kladovo,8,,888,454,888,434,434,6,428,190,238
70572,Kladovo,9,,783,467,783,316,316,5,311,211,100
70572,Kladovo,10,,687,430,687,257,257,6,251,125,126
70572,Kladovo,11,,551,395,551,156,156,3,153,104,49
70572,Kladovo,12,,471,226,471,245,245,4,241,139,102
70572,Kladovo,13,,327,151,327,176,176,5,171,65,106
70572,Kladovo,14,,508,213,508,295,295,6,289,137,152
70572,Kladovo,15,,521,243,521,278,278,3,275,149,126
70572,Kladovo,16,,853,577,853,276,276,8,268,174,94
70572,Kladovo,17,,557,390,557,167,167,1,166,104,62
70572,Kladovo,18,,112,87,112,25,25,0,25,21,4
70572,Kladovo,19,,817,543,817,274,274,5,269,166,103
70572,Kladovo,20,,662,372,662,290,290,9,281,144,137
70572,Kladovo,21,,437,255,437,182,182,6,176,85,91
70572,Kladovo,22,,689,422,689,267,267,6,261,171,90
70572,Kladovo,23,,462,330,462,132,132,0,132,94,38
70572,Kladovo,24,,670,469,670,201,201,8,193,116,77
70572,Kladovo,25,,415,208,415,207,207,8,199,109,90
70572,Kladovo,26,,855,486,755,369,369,9,360,168,192
70572,Kladovo,27,,341,187,341,154,154,3,151,46,105
70572,Kladovo,28,,529,193,530,336,336,4,332,134,198
70572,Kladovo,29,,932,382,931,550,550,17,533,339,194
70572,Kladovo,30,,582,300,582,282,282,5,277,142,135
70572,Kladovo,31,,658,265,658,393,393,13,380,195,185
70572,Kladovo,32,,522,177,522,345,345,7,338,174,164
70572,Kladovo,33,,683,254,683,429,429,15,414,186,228
70572,Kladovo,34,,522,370,522,152,152,3,149,105,44
70572,Kladovo,35,,1072,724,1072,348,348,10,338,183,155
70572,Kladovo,36,,181,117,181,64,64,2,62,29,33
70572,Kladovo,37,,127,92,127,35,35,1,34,19,15
70572,Kladovo,38,,478,251,478,227,227,4,223,107,116
70572,Kladovo,39,,112,64,112,48,48,0,48,38,10
70572,Kladovo,40,,248,100,248,148,148,1,147,61,86
70572,Kladovo,41,,201,114,202,87,87,1,86,49,37
70599,Knić,1,,563,299,563,264,264,4,260,186,74
70599,Knić,2,,346,199,346,147,147,1,146,95,51
70599,Knić,3,,115,72,115,43,43,0,43,17,26
70599,Knić,4,,424,246,424,178,178,2,176,77,99
70599,Knić,5,,266,120,266,146,146,4,142,47,95
70599,Knić,6,,550,275,550,275,275,6,269,125,144
70599,Knić,7,,276,131,276,145,145,3,142,46,96
70599,Knić,8,,145,79,145,66,66,0,66,17,49
70599,Knić,9,,406,194,406,212,212,1,211,88,123
70599,Knić,10,,594,397,594,197,197,3,194,123,71
70599,Knić,11,,347,189,347,158,158,10,148,77,71
70599,Knić,12,,547,221,547,326,326,4,322,166,156
70599,Knić,13,,280,144,280,136,136,1,135,92,43
70599,Knić,14,,440,261,440,179,179,4,175,65,110
70599,Knić,15,,179,105,179,74,74,0,74,21,53
70599,Knić,16,,463,303,463,160,160,2,158,79,79
70599,Knić,17,,349,235,349,114,114,2,112,48,64
70599,Knić,18,,203,103,203,100,100,1,99,45,54
70599,Knić,19,,247,128,247,119,119,2,117,58,59
70599,Knić,20,,459,261,459,198,198,0,198,80,118
70599,Knić,21,,167,79,167,88,88,1,87,56,31
70599,Knić,22,,812,456,812,356,356,5,351,184,167
70599,Knić,23,,569,308,569,261,261,1,260,135,125
70599,Knić,24,,674,331,674,343,343,4,339,210,129
70599,Knić,25,,295,156,296,139,139,4,135,92,43
70599,Knić,26,,222,75,222,147,147,0,147,59,88
70599,Knić,27,,428,250,428,178,178,4,174,109,65
70599,Knić,28,,346,204,346,142,142,1,141,99,42
70599,Knić,29,,280,164,280,116,116,1,115,55,60
70599,Knić,30,,358,149,358,209,209,2,207,98,109
70599,Knić,31,,426,223,426,203,203,4,199,111,88
70599,Knić,32,,456,325,456,131,131,3,128,58,70
70599,Knić,33,,215,137,215,78,78,0,78,37,41
70599,Knić,34,,431,218,431,213,213,2,211,82,129
70599,Knić,35,,196,81,196,115,115,2,113,47,66
70602,Knjaževac,1,,843,568,843,275,275,2,273,177,96
70602,Knjaževac,2,,806,516,806,290,290,4,286,135,151
70602,Knjaževac,3,,737,430,737,307,307,3,304,127,177
70602,Knjaževac,4,,833,463,834,370,370,6,364,157,207
70602,Knjaževac,5,,730,431,730,299,299,3,296,128,168
70602,Knjaževac,6,,888,686,887,202,202,7,195,107,88
70602,Knjaževac,7,,643,393,643,250,250,3,247,129,118
70602,Knjaževac,8,,1023,596,1023,427,427,7,420,177,243
70602,Knjaževac,9,,948,577,948,371,371,5,366,173,193
70602,Knjaževac,10,,768,401,768,367,366,1,365,148,217
70602,Knjaževac,11,,716,408,716,308,308,4,304,142,162
70602,Knjaževac,12,,882,506,882,376,376,3,373,153,220
70602,Knjaževac,13,,783,464,783,319,319,4,315,131,184
70602,Knjaževac,14,,702,393,702,309,309,12,297,142,155
70602,Knjaževac,15,,1011,539,1011,472,472,4,468,151,317
70602,Knjaževac,16,,888,511,888,377,377,5,372,185,187
70602,Knjaževac,17,,841,436,841,405,405,2,403,170,233
70602,Knjaževac,18,,977,561,977,416,416,6,410,218,192
70602,Knjaževac,19,,841,501,841,340,340,4,336,203,133
70602,Knjaževac,20,,1018,693,1018,325,325,3,322,172,150
70602,Knjaževac,21,,413,210,413,203,203,4,199,68,131
70602,Knjaževac,22,,195,132,195,63,63,2,61,44,17
70602,Knjaževac,23,,438,245,438,193,193,4,189,113,76
70602,Knjaževac,24,,266,160,267,106,106,1,105,54,51
70602,Knjaževac,25,,209,117,209,92,92,2,90,63,27
70602,Knjaževac,26,,309,178,309,131,131,2,129,83,46
70602,Knjaževac,27,,120,52,120,68,68,2,66,42,24
70602,Knjaževac,28,,114,54,114,60,60,1,59,35,24
70602,Knjaževac,29,,117,77,117,40,40,0,40,26,14
70602,Knjaževac,30,,295,165,295,130,130,1,129,85,44
70602,Knjaževac,31,,151,89,151,62,62,1,61,53,8
70602,Knjaževac,32,,134,72,134,62,62,0,62,40,22
70602,Knjaževac,33,,336,150,336,186,186,1,185,82,103
70602,Knjaževac,34,,261,196,261,65,65,1,64,26,38
70602,Knjaževac,35,,276,140,276,136,136,5,131,75,56
70602,Knjaževac,36,,765,440,765,325,325,11,314,138,176
70602,Knjaževac,37,,111,69,111,42,42,1,41,24,17
70602,Knjaževac,38,,369,236,369,133,133,4,129,74,55
70602,Knjaževac,39,,111,74,111,37,37,0,37,25,12
70602,Knjaževac,40,,167,119,167,48,48,0,48,31,17
70602,Knjaževac,41,,181,127,181,54,54,0,54,25,29
70602,Knjaževac,42,,385,264,385,121,121,2,119,72,47
70602,Knjaževac,43,,106,53,106,53,53,1,52,29,23
70602,Knjaževac,44,,119,56,119,63,63,0,63,45,18
70602,Knjaževac,45,,192,66,192,126,126,8,118,78,40
70602,Knjaževac,46,,289,166,289,123,123,2,121,82,39
70602,Knjaževac,47,,440,223,440,217,217,2,215,150,65
70602,Knjaževac,48,,164,71,164,93,93,3,90,66,24
70602,Knjaževac,49,,265,171,265,94,94,1,93,59,34
70602,Knjaževac,50,,270,135,270,135,135,0,135,97,38
70602,Knjaževac,51,,357,234,357,123,123,3,120,66,54
70602,Knjaževac,52,,187,137,187,50,50,0,50,24,26
70602,Knjaževac,53,,244,160,244,84,84,1,83,52,31
70602,Knjaževac,54,,255,113,255,142,142,7,135,104,31
70602,Knjaževac,55,,100,20,100,80,80,3,77,50,27
70602,Knjaževac,56,,158,75,158,83,83,0,83,62,21
70602,Knjaževac,57,,315,184,315,131,131,3,128,65,63
70602,Knjaževac,58,,272,136,273,136,136,1,135,55,80
70602,Knjaževac,59,,275,125,275,150,150,3,147,91,56
70602,Knjaževac,60,,131,59,131,72,72,1,71,59,12
70602,Knjaževac,61,,143,86,143,57,57,1,56,35,21
70602,Knjaževac,62,,124,42,124,82,82,2,80,46,34
70602,Knjaževac,63,,127,51,127,76,76,2,74,49,25
70602,Knjaževac,64,,109,44,109,65,65,1,64,46,18
70602,Knjaževac,65,,100,66,100,34,34,1,33,19,14
70602,Knjaževac,66,,840,554,840,286,286,2,284,167,117
70602,Knjaževac,67,,878,609,878,269,269,4,265,160,105
70602,Knjaževac,68,,208,78,208,130,130,1,129,69,60
70602,Knjaževac,69,,131,68,131,63,63,2,61,37,24
70602,Knjaževac,70,,107,53,107,54,54,0,54,38,16
70602,Knjaževac,71,,156,113,156,43,43,1,42,29,13
70602,Knjaževac,72,,277,105,277,172,172,2,170,122,48
70602,Knjaževac,73,,353,176,353,177,177,1,176,106,70
70602,Knjaževac,74,,593,363,593,230,230,4,226,135,91
70602,Knjaževac,75,,164,108,164,56,56,1,55,36,19
70602,Knjaževac,76,,211,161,211,50,50,0,50,39,11
70602,Knjaževac,77,,165,72,165,93,93,0,93,79,14
70602,Knjaževac,78,,173,75,173,98,98,0,98,72,26
70602,Knjaževac,79,,233,174,233,59,59,1,58,56,2
70602,Knjaževac,80,,192,96,192,96,96,2,94,69,25
70629,Kosjerić,1,,456,213,456,243,243,4,239,127,112
70629,Kosjerić,2,,472,332,472,140,140,5,135,70,65
70629,Kosjerić,3,,257,122,257,135,135,0,135,68,67
70629,Kosjerić,4,,574,292,574,282,282,2,280,112,168
70629,Kosjerić,5,,218,115,218,103,103,1,102,30,72
70629,Kosjerić,6,,115,48,115,67,67,2,65,19,46
70629,Kosjerić,7,,256,108,256,148,148,1,147,49,98
70629,Kosjerić,8,,100,48,100,52,52,0,52,26,26
70629,Kosjerić,9,,302,140,302,162,162,3,159,77,82
70629,Kosjerić,10,,163,54,163,109,109,1,108,45,63
70629,Kosjerić,11,,216,92,216,124,124,1,123,58,65
70629,Kosjerić,12,,321,91,321,230,230,2,228,84,144
70629,Kosjerić,13,,101,54,101,47,47,0,47,28,19
70629,Kosjerić,14,,234,115,234,119,119,5,114,63,51
70629,Kosjerić,15,,298,163,298,135,135,4,131,52,79
70629,Kosjerić,16,,187,97,187,90,90,1,89,44,45
70629,Kosjerić,17,,100,43,100,57,57,0,57,26,31
70629,Kosjerić,18,,460,258,461,202,202,3,199,90,109
70629,Kosjerić,19,,187,125,187,62,62,3,59,13,46
70629,Kosjerić,20,,186,70,186,116,116,4,112,43,69
70629,Kosjerić,21,,353,183,353,170,170,3,167,63,104
70629,Kosjerić,22,,457,231,457,226,226,0,226,94,132
70629,Kosjerić,23,,392,150,392,242,242,7,235,108,127
70629,Kosjerić,24,,288,147,288,141,141,0,141,95,46
70629,Kosjerić,25,,421,228,421,193,193,4,189,103,86
70629,Kosjerić,26,,178,112,178,66,66,0,66,38,28
70629,Kosjerić,27,,660,345,660,315,315,1,314,120,194
70629,Kosjerić,28,,390,164,390,226,226,11,215,54,161
70629,Kosjerić,29,,494,259,494,235,235,0,235,81,154
70629,Kosjerić,30,,673,276,673,397,397,9,388,124,264
70629,Kosjerić,31,,574,252,574,322,322,4,318,109,209
70629,Kosjerić,32,,623,229,623,394,394,10,384,124,260
70629,Kosjerić,33,,608,223,608,385,385,5,380,100,280
70637,Koceljeva,1,,399,169,399,230,230,2,228,147,81
70637,Koceljeva,2,,638,303,638,335,335,4,331,215,116
70637,Koceljeva,3,,678,407,678,271,271,3,268,85,183
70637,Koceljeva,4,,189,94,189,95,95,2,93,72,21
70637,Koceljeva,5,,176,74,176,102,102,2,100,58,42
70637,Koceljeva,6,,478,280,478,198,198,2,196,95,101
70637,Koceljeva,7,,179,80,179,99,99,0,99,60,39
70637,Koceljeva,8,,546,302,546,244,244,2,242,113,129
70637,Koceljeva,9,,260,167,260,93,93,1,92,63,29
70637,Koceljeva,10,,329,155,329,174,174,3,171,69,102
70637,Koceljeva,11,,425,211,425,214,214,6,208,167,41
70637,Koceljeva,12,,593,384,593,209,209,6,203,105,98
70637,Koceljeva,13,,547,328,547,219,219,9,210,134,76
70637,Koceljeva,14,,210,98,210,112,112,1,111,82,29
70637,Koceljeva,15,,328,168,328,160,160,2,158,96,62
70637,Koceljeva,16,,251,139,251,112,112,3,109,83,26
70637,Koceljeva,17,,186,82,186,104,104,1,103,72,31
70637,Koceljeva,18,,210,107,210,103,103,1,102,57,45
70637,Koceljeva,19,,309,166,309,143,143,3,140,89,51
70637,Koceljeva,20,,574,326,574,248,248,2,246,140,106
70637,Koceljeva,21,,485,288,485,197,197,8,189,115,74
70637,Koceljeva,22,,476,205,476,271,271,12,259,113,146
70637,Koceljeva,23,,832,364,832,468,468,20,448,187,261
70637,Koceljeva,24,,661,367,661,294,294,4,290,191,99
70637,Koceljeva,25,,513,263,513,250,250,2,248,178,70
70637,Koceljeva,26,,245,105,245,140,140,5,135,105,30
70637,Koceljeva,27,,295,155,295,140,140,3,137,115,22
70637,Koceljeva,28,,183,69,183,114,114,0,114,97,17
70637,Koceljeva,29,,336,167,336,169,169,2,167,112,55
70637,Koceljeva,30,,300,177,300,123,123,1,122,77,45
70637,Koceljeva,31,,234,71,234,163,163,3,160,61,99
70637,Koceljeva,32,,119,62,119,57,57,1,56,38,18
70637,Koceljeva,33,,245,116,245,129,129,2,127,92,35
70637,Koceljeva,34,,297,109,297,188,188,5,183,144,39
70645,Kragujevac-grad,1,,1314,571,1314,743,743,4,739,285,454
70645,Kragujevac-grad,2,,1254,535,1254,719,719,21,698,241,457
70645,Kragujevac-grad,3,,1416,576,1416,840,840,15,825,329,496
70645,Kragujevac-grad,4,,1343,607,1343,736,736,8,728,290,438
70645,Kragujevac-grad,5,,1632,766,1632,866,865,18,847,348,499
70645,Kragujevac-grad,6,,2296,1064,2298,1232,1232,15,1217,509,708
70645,Kragujevac-grad,7,,2188,1110,2188,1078,1078,22,1056,629,427
70645,Kragujevac-grad,8,,1949,835,1949,1114,1114,19,1095,416,679
70645,Kragujevac-grad,9,,1144,544,1144,600,600,11,589,210,379
70645,Kragujevac-grad,10,,1303,546,1303,757,757,7,750,283,467
70645,Kragujevac-grad,11,,538,250,538,288,288,5,283,101,182
70645,Kragujevac-grad,12,,1003,423,1003,580,580,5,575,185,390
70645,Kragujevac-grad,13,,869,346,869,523,523,11,512,156,356
70645,Kragujevac-grad,14,,513,200,513,313,313,7,306,105,201
70645,Kragujevac-grad,15,,908,385,908,523,523,12,511,172,339
70645,Kragujevac-grad,16,,641,290,641,351,351,4,347,127,220
70645,Kragujevac-grad,17,,1215,595,1215,620,620,8,612,271,341
70645,Kragujevac-grad,18,,970,390,970,580,580,11,569,210,359
70645,Kragujevac-grad,19,,806,393,807,413,413,8,405,143,262
70645,Kragujevac-grad,20,,1115,515,1115,600,600,15,585,231,354
70645,Kragujevac-grad,21,,545,223,545,322,322,6,316,125,191
70645,Kragujevac-grad,22,,1715,810,1715,905,905,8,897,341,556
70645,Kragujevac-grad,23,,1454,646,1454,808,808,16,792,271,521
70645,Kragujevac-grad,24,,1595,652,1595,943,943,15,928,290,638
70645,Kragujevac-grad,25,,2083,1027,2083,1056,1056,12,1044,397,647
70645,Kragujevac-grad,26,,1493,699,1493,794,794,9,785,311,474
70645,Kragujevac-grad,27,,1612,733,1612,879,879,13,866,379,487
70645,Kragujevac-grad,28,,1745,781,1745,964,963,9,954,406,548
70645,Kragujevac-grad,29,,1362,649,1364,713,713,6,707,259,448
70645,Kragujevac-grad,30,,1874,914,1875,960,960,25,935,340,595
70645,Kragujevac-grad,31,,2127,881,2130,1246,1245,12,1233,399,834
70645,Kragujevac-grad,32,,1124,520,1124,604,604,3,601,203,398
70645,Kragujevac-grad,33,,1092,428,1093,664,664,7,657,206,451
70645,Kragujevac-grad,34,,1332,493,1332,839,839,13,826,251,575
70645,Kragujevac-grad,35,,1403,549,1403,854,850,14,836,261,575
70645,Kragujevac-grad,36,,1283,492,1284,791,790,11,779,212,567
70645,Kragujevac-grad,37,,1617,607,1617,1010,1010,23,987,287,700
70645,Kragujevac-grad,38,,1680,710,1680,970,970,16,954,257,697
70645,Kragujevac-grad,39,,1677,655,1677,1022,1021,22,999,307,692
70645,Kragujevac-grad,40,,1569,707,1570,862,862,12,850,377,473
70645,Kragujevac-grad,41,,1301,578,1301,723,723,10,713,257,456
70645,Kragujevac-grad,42,,1719,767,1719,952,952,13,939,335,604
70645,Kragujevac-grad,43,,1581,790,1581,791,791,16,775,411,364
70645,Kragujevac-grad,44,,1579,827,1580,752,752,6,746,577,169
70645,Kragujevac-grad,45,,1895,863,1895,1032,1030,12,1018,549,469
70645,Kragujevac-grad,46,,1544,642,1544,902,902,8,894,347,547
70645,Kragujevac-grad,47,,2265,970,2269,1295,1295,23,1272,324,948
70645,Kragujevac-grad,48,,1536,639,1536,897,897,23,874,228,646
70645,Kragujevac-grad,49,,1318,575,1318,743,743,9,734,273,461
70645,Kragujevac-grad,50,,1308,539,1308,769,769,34,735,162,573
70645,Kragujevac-grad,51,,1141,514,1141,627,627,10,617,205,412
70645,Kragujevac-grad,52,,1250,537,1250,713,713,10,703,258,445
70645,Kragujevac-grad,53,,1502,726,1502,776,776,13,763,306,457
70645,Kragujevac-grad,54,,1193,528,1194,665,665,10,655,242,413
70645,Kragujevac-grad,55,,1259,586,1259,673,673,8,665,311,354
70645,Kragujevac-grad,56,,1634,901,1635,733,733,7,726,520,206
70645,Kragujevac-grad,57,,1457,676,1457,781,781,10,771,443,328
70645,Kragujevac-grad,58,,1469,781,1469,688,688,13,675,495,180
70645,Kragujevac-grad,59,,1161,531,1161,630,630,3,627,468,159
70645,Kragujevac-grad,60,,1220,611,1221,609,609,5,604,365,239
70645,Kragujevac-grad,61,,241,101,241,140,140,1,139,72,67
70645,Kragujevac-grad,62,,852,397,853,455,455,6,449,250,199
70645,Kragujevac-grad,63,,576,330,574,246,246,1,245,202,43
70645,Kragujevac-grad,64,,1445,750,1445,695,694,8,686,451,235
70645,Kragujevac-grad,65,,1752,885,1754,867,867,13,854,629,225
70645,Kragujevac-grad,66,,1466,817,1466,649,649,10,639,461,178
70645,Kragujevac-grad,67,,1753,1037,1755,716,716,3,713,536,177
70645,Kragujevac-grad,68,,1756,883,1756,873,873,11,862,532,330
70645,Kragujevac-grad,69,,1629,790,1632,839,837,13,824,403,421
70645,Kragujevac-grad,70,,1551,804,1554,747,747,2,745,511,234
70645,Kragujevac-grad,71,,1715,900,1715,815,815,12,803,400,403
70645,Kragujevac-grad,72,,1376,651,1380,725,725,15,710,317,393
70645,Kragujevac-grad,73,,1718,823,1719,895,895,10,885,420,465
70645,Kragujevac-grad,74,,974,513,974,461,461,5,456,295,161
70645,Kragujevac-grad,75,,1046,578,1046,468,468,5,463,275,188
70645,Kragujevac-grad,76,,304,183,304,121,121,3,118,76,42
70645,Kragujevac-grad,77,,953,583,953,370,370,7,363,221,142
70645,Kragujevac-grad,78,,1164,678,1164,486,486,2,484,249,235
70645,Kragujevac-grad,79,,683,364,683,319,319,1,318,175,143
70645,Kragujevac-grad,80,,874,475,874,399,399,5,394,180,214
70645,Kragujevac-grad,81,,629,374,629,255,255,2,253,110,143
70645,Kragujevac-grad,82,,913,438,913,475,475,10,465,170,295
70645,Kragujevac-grad,83,,731,390,732,341,341,2,339,190,149
70645,Kragujevac-grad,84,,861,453,861,408,408,4,404,227,177
70645,Kragujevac-grad,85,,1583,887,1572,696,696,12,684,405,279
70645,Kragujevac-grad,86,,1614,853,1615,761,761,3,758,506,252
70645,Kragujevac-grad,87,,1968,910,1968,1058,1058,14,1044,517,527
70645,Kragujevac-grad,88,,406,204,406,202,202,7,195,112,83
70645,Kragujevac-grad,89,,2230,1110,2230,1120,1119,14,1105,554,551
70645,Kragujevac-grad,90,,1108,576,1108,532,532,7,525,269,256
70645,Kragujevac-grad,91,,481,295,481,186,186,1,185,99,86
70645,Kragujevac-grad,92,,432,224,432,208,208,3,205,90,115
70645,Kragujevac-grad,93,,1262,672,1262,590,590,11,579,319,260
70645,Kragujevac-grad,94,,589,296,590,293,293,3,290,201,89
70645,Kragujevac-grad,95,,326,196,326,130,130,2,128,60,68
70645,Kragujevac-grad,96,,583,287,583,296,296,5,291,183,108
70645,Kragujevac-grad,97,,504,263,505,241,241,2,239,151,88
70645,Kragujevac-grad,98,,341,199,341,142,142,2,140,96,44
70645,Kragujevac-grad,99,,757,411,757,346,346,5,341,225,116
70645,Kragujevac-grad,100,,737,362,737,375,375,10,365,271,94
70645,Kragujevac-grad,101,,668,275,668,393,393,19,374,175,199
70645,Kragujevac-grad,102,,277,180,277,97,97,1,96,58,38
70645,Kragujevac-grad,103,,170,69,170,101,101,0,101,24,77
70645,Kragujevac-grad,104,,264,162,264,102,102,1,101,11,90
70645,Kragujevac-grad,105,,229,140,229,89,89,1,88,22,66
70645,Kragujevac-grad,106,,268,167,268,101,101,4,97,14,83
70645,Kragujevac-grad,107,,469,271,469,198,198,3,195,52,143
70645,Kragujevac-grad,108,,134,69,134,65,65,0,65,19,46
70645,Kragujevac-grad,109,,2043,1204,2043,839,839,6,833,503,330
70645,Kragujevac-grad,110,,1064,594,1064,470,470,5,465,289,176
70645,Kragujevac-grad,111,,468,313,468,155,155,2,153,92,61
70645,Kragujevac-grad,112,,568,334,568,234,234,3,231,107,124
70645,Kragujevac-grad,113,,578,214,578,364,364,3,361,186,175
70645,Kragujevac-grad,114,,246,144,246,102,102,2,100,60,40
70645,Kragujevac-grad,115,,482,262,482,220,220,1,219,168,51
70645,Kragujevac-grad,116,,348,209,348,139,139,3,136,82,54
70645,Kragujevac-grad,117,,229,129,229,100,100,2,98,61,37
70645,Kragujevac-grad,118,,127,80,127,47,47,1,46,24,22
70645,Kragujevac-grad,119,,227,99,227,128,128,2,126,88,38
70645,Kragujevac-grad,120,,687,409,687,278,278,2,276,167,109
70645,Kragujevac-grad,121,,168,73,168,95,95,1,94,66,28
70645,Kragujevac-grad,122,,423,279,423,144,144,2,142,84,58
70645,Kragujevac-grad,123,,172,116,172,56,56,0,56,32,24
70645,Kragujevac-grad,124,,571,350,571,221,221,6,215,109,106
70645,Kragujevac-grad,125,,284,158,284,126,126,0,126,90,36
70645,Kragujevac-grad,126,,660,369,661,291,291,1,290,133,157
70645,Kragujevac-grad,127,,667,359,666,308,308,4,304,178,126
70645,Kragujevac-grad,128,,361,217,361,144,144,1,143,66,77
70645,Kragujevac-grad,129,,1006,514,1006,492,492,5,487,276,211
70645,Kragujevac-grad,130,,209,131,209,78,78,0,78,33,45
70645,Kragujevac-grad,131,,132,45,132,87,87,2,85,37,48
70645,Kragujevac-grad,132,,317,120,317,197,197,6,191,89,102
70645,Kragujevac-grad,133,,191,83,191,108,108,1,107,56,51
70645,Kragujevac-grad,134,,219,137,219,82,82,1,81,32,49
70645,Kragujevac-grad,135,,207,64,207,143,64,2,62,39,23
70645,Kragujevac-grad,136,,109,54,109,55,55,0,55,34,21
70645,Kragujevac-grad,137,,151,68,151,83,83,0,83,33,50
70645,Kragujevac-grad,138,,416,223,416,193,193,9,184,46,138
70645,Kragujevac-grad,139,,636,430,636,206,206,3,203,72,131
70645,Kragujevac-grad,140,,369,205,369,164,164,1,163,87,76
70645,Kragujevac-grad,141,,321,206,321,115,115,0,115,78,37
70645,Kragujevac-grad,142,,138,72,138,66,66,0,66,42,24
70645,Kragujevac-grad,143,,299,166,299,133,133,4,129,78,51
70645,Kragujevac-grad,144,,194,125,194,69,69,0,69,37,32
70645,Kragujevac-grad,145,,249,164,249,85,85,1,84,59,25
70645,Kragujevac-grad,146,,511,306,511,205,205,1,204,68,136
70645,Kragujevac-grad,147,,748,453,748,295,295,3,292,152,140
70645,Kragujevac-grad,148,,349,171,349,178,178,0,178,69,109
70645,Kragujevac-grad,149,,905,516,905,389,389,8,381,164,217
70645,Kragujevac-grad,150,,908,543,942,365,365,7,358,247,111
70645,Kragujevac-grad,151,,467,252,467,215,215,3,212,138,74
70645,Kragujevac-grad,152,,370,202,370,168,168,2,166,102,64
70645,Kragujevac-grad,153,,294,167,295,127,127,2,125,78,47
70645,Kragujevac-grad,154,,738,433,738,305,305,3,302,129,173
70645,Kragujevac-grad,155,,791,373,791,418,418,4,414,195,219
70645,Kragujevac-grad,156,,1087,578,1087,509,509,5,504,224,280
70645,Kragujevac-grad,157,,1197,661,1197,536,536,6,530,384,146
70645,Kragujevac-grad,158,,1138,619,1138,519,519,8,511,348,163
70653,Kraljevo,1,,1689,974,1689,715,715,21,694,339,355
70653,Kraljevo,2,,1502,801,1502,701,701,5,696,348,348
70653,Kraljevo,3,,1917,1098,1917,819,819,8,811,400,411
70653,Kraljevo,4,,1492,870,1492,622,622,3,619,294,325
70653,Kraljevo,5,,1939,1076,1939,863,863,8,855,318,537
70653,Kraljevo,6,,1569,767,1575,802,802,13,789,281,508
70653,Kraljevo,7,,1476,708,1476,768,768,10,758,243,515
70653,Kraljevo,8,,1442,710,1442,732,732,7,725,197,528
70653,Kraljevo,9,,1488,730,1488,758,758,12,746,212,534
70653,Kraljevo,10,,1442,757,1442,685,684,12,672,298,374
70653,Kraljevo,11,,1562,773,1562,789,789,14,775,233,542
70653,Kraljevo,12,,1629,793,1629,836,836,9,827,295,532
70653,Kraljevo,13,,1801,915,1801,886,885,12,873,339,534
70653,Kraljevo,14,,1702,1132,1702,570,570,5,565,295,270
70653,Kraljevo,15,,1587,767,1587,820,820,11,809,285,524
70653,Kraljevo,16,,1429,670,1429,759,759,8,751,260,491
70653,Kraljevo,17,,1969,981,1970,988,986,14,972,333,639
70653,Kraljevo,18,,1601,760,1601,841,841,18,823,285,538
70653,Kraljevo,19,,1634,851,1634,783,783,11,772,308,464
70653,Kraljevo,20,,1872,1001,1872,871,871,12,859,379,480
70653,Kraljevo,21,,1892,1018,1892,874,874,4,870,446,424
70653,Kraljevo,22,,1456,748,1456,708,708,12,696,363,333
70653,Kraljevo,23,,2075,1306,2074,769,769,6,763,437,326
70653,Kraljevo,24,,1640,803,1640,837,837,20,817,317,500
70653,Kraljevo,25,,1898,1103,1898,795,795,7,788,394,394
70653,Kraljevo,26,,2107,1170,2107,937,937,10,927,461,466
70653,Kraljevo,27,,1419,703,1419,716,716,7,709,304,405
70653,Kraljevo,28,,815,288,815,527,527,22,505,188,317
70653,Kraljevo,29,,1997,1072,1997,925,925,8,917,414,503
70653,Kraljevo,30,,2276,1299,2276,977,977,7,970,580,390
70653,Kraljevo,31,,2031,1205,2031,826,826,11,815,414,401
70653,Kraljevo,32,,502,267,502,235,235,3,232,126,106
70653,Kraljevo,33,,688,458,688,230,230,1,229,126,103
70653,Kraljevo,34,,797,490,797,307,307,3,304,160,144
70653,Kraljevo,35,,357,217,357,140,140,1,139,76,63
70653,Kraljevo,36,,721,417,721,304,304,6,298,136,162
70653,Kraljevo,37,,369,215,369,154,154,7,147,70,77
70653,Kraljevo,38,,245,158,245,87,87,2,85,57,28
70653,Kraljevo,39,,244,171,244,73,73,0,73,29,44
70653,Kraljevo,40,,140,88,140,52,52,1,51,31,20
70653,Kraljevo,41,,180,91,181,89,89,4,85,44,41
70653,Kraljevo,42,,207,80,207,127,127,0,127,78,49
70653,Kraljevo,43,,1080,681,1080,399,399,6,393,150,243
70653,Kraljevo,44,,1219,875,1219,344,344,5,339,189,150
70653,Kraljevo,45,,305,164,305,141,141,3,138,86,52
70653,Kraljevo,46,,660,416,660,244,244,1,243,107,136
70653,Kraljevo,47,,890,635,890,255,255,2,253,112,141
70653,Kraljevo,48,,298,146,298,152,152,3,149,65,84
70653,Kraljevo,49,,121,57,121,64,64,0,64,38,26
70653,Kraljevo,50,,1932,1130,1936,802,802,10,792,424,368
70653,Kraljevo,51,,1305,872,1305,433,433,4,429,251,178
70653,Kraljevo,52,,1242,744,1242,498,498,6,492,294,198
70653,Kraljevo,53,,1300,704,1300,596,596,11,585,333,252
70653,Kraljevo,54,,809,503,809,306,306,2,304,182,122
70653,Kraljevo,55,,386,205,386,181,181,1,180,98,82
70653,Kraljevo,56,,150,87,150,63,63,0,63,28,35
70653,Kraljevo,57,,634,340,634,294,294,2,292,158,134
70653,Kraljevo,58,,1949,1078,1949,871,871,7,864,456,408
70653,Kraljevo,59,,397,237,397,160,160,0,160,110,50
70653,Kraljevo,60,,1208,727,1208,481,481,6,475,202,273
70653,Kraljevo,61,,748,465,748,283,283,10,273,121,152
70653,Kraljevo,62,,244,140,244,104,104,3,101,72,29
70653,Kraljevo,63,,581,345,581,236,236,3,233,120,113
70653,Kraljevo,64,,320,209,320,111,111,1,110,47,63
70653,Kraljevo,65,,875,569,875,306,306,8,298,131,167
70653,Kraljevo,66,,576,348,576,228,228,1,227,101,126
70653,Kraljevo,67,,629,322,629,307,307,6,301,123,178
70653,Kraljevo,68,,564,375,564,189,189,1,188,100,88
70653,Kraljevo,69,,1057,725,1057,332,332,4,328,202,126
70653,Kraljevo,70,,1113,658,1113,455,455,3,452,196,256
70653,Kraljevo,71,,248,104,248,144,144,3,141,75,66
70653,Kraljevo,72,,200,94,200,106,106,0,106,47,59
70653,Kraljevo,73,,1324,863,1324,461,461,6,455,267,188
70653,Kraljevo,74,,501,334,501,167,167,1,166,67,99
70653,Kraljevo,75,,698,434,698,264,264,5,259,101,158
70653,Kraljevo,76,,769,437,769,332,332,11,321,179,142
70653,Kraljevo,77,,1111,589,1111,522,522,3,519,273,246
70653,Kraljevo,78,,372,248,372,124,124,2,122,43,79
70653,Kraljevo,79,,162,94,162,68,68,1,67,18,49
70653,Kraljevo,80,,133,82,133,51,51,0,51,14,37
70653,Kraljevo,81,,145,95,145,50,50,0,50,33,17
70653,Kraljevo,82,,219,135,219,84,84,0,84,48,36
70653,Kraljevo,83,,772,456,772,316,316,6,310,178,132
70653,Kraljevo,84,,505,308,505,197,197,2,195,94,101
70653,Kraljevo,85,,1608,958,1608,650,650,5,645,398,247
70653,Kraljevo,86,,1416,703,1417,713,713,27,686,307,379
70653,Kraljevo,87,,1877,1018,1877,859,859,4,855,495,360
70653,Kraljevo,88,,1797,1082,1797,715,715,6,709,433,276
70653,Kraljevo,89,,571,348,571,223,223,4,219,103,116
70653,Kraljevo,90,,695,367,695,328,328,2,326,188,138
70653,Kraljevo,91,,462,233,462,229,229,5,224,141,83
70653,Kraljevo,92,,1469,904,1469,565,565,10,555,355,200
70653,Kraljevo,93,,689,469,689,220,220,5,215,87,128
70653,Kraljevo,94,,1871,1025,1871,846,846,2,844,365,479
70653,Kraljevo,95,,1038,646,1039,392,392,8,384,249,135
70653,Kraljevo,96,,434,213,434,221,221,1,220,105,115
70653,Kraljevo,97,,758,491,758,267,267,0,267,134,133
70653,Kraljevo,98,,1204,698,1204,506,506,9,497,266,231
70653,Kraljevo,99,,970,553,971,417,417,6,411,204,207
70653,Kraljevo,100,,382,227,382,155,155,1,154,75,79
70653,Kraljevo,101,,113,63,113,50,50,2,48,22,26
70653,Kraljevo,102,,565,326,565,239,239,7,232,142,90
70653,Kraljevo,103,,248,164,248,84,84,2,82,39,43
70653,Kraljevo,104,,139,62,139,77,77,0,77,44,33
70653,Kraljevo,105,,122,88,122,34,34,2,32,16,16
70653,Kraljevo,106,,169,118,169,51,51,0,51,38,13
70653,Kraljevo,107,,340,220,340,120,120,2,118,69,49
70653,Kraljevo,108,,1656,838,1656,818,818,18,800,453,347
70653,Kraljevo,109,,257,151,258,106,106,2,104,63,41
70653,Kraljevo,110,,262,146,261,116,116,2,114,52,62
70653,Kraljevo,111,,116,57,116,59,59,0,59,28,31
70653,Kraljevo,112,,244,148,244,96,96,3,93,62,31
70653,Kraljevo,113,,219,143,219,76,76,2,74,57,17
70653,Kraljevo,114,,271,159,271,112,112,3,109,61,48
70653,Kraljevo,115,,189,127,189,62,62,1,61,49,12
70653,Kraljevo,116,,219,148,219,71,71,1,70,47,23
70653,Kraljevo,117,,105,78,105,27,27,0,27,22,5
70653,Kraljevo,118,,239,175,239,64,64,0,64,54,10
70653,Kraljevo,119,,147,84,147,63,63,0,63,46,17
70653,Kraljevo,120,,165,102,165,63,63,1,62,25,37
70653,Kraljevo,121,,343,198,343,145,145,3,142,78,64
70653,Kraljevo,122,,145,70,144,75,75,0,75,67,8
70653,Kraljevo,123,,162,95,162,67,67,0,67,47,20
70653,Kraljevo,124,,127,80,127,47,47,1,46,31,15
70653,Kraljevo,125,,140,73,140,67,67,3,64,46,18
70653,Kraljevo,126,,206,90,206,116,116,4,112,58,54
70653,Kraljevo,127,,220,149,220,71,71,1,70,50,20
70653,Kraljevo,128,,178,75,178,103,103,2,101,48,53
70653,Kraljevo,129,,186,93,186,93,93,3,90,36,54
70661,Krupanj,1,,169,98,169,71,71,0,71,50,21
70661,Krupanj,2,,216,108,216,108,108,1,107,56,51
70661,Krupanj,3,,595,254,595,341,341,5,336,216,120
70661,Krupanj,4,,200,121,200,79,79,0,79,52,27
70661,Krupanj,5,,444,238,444,206,206,2,204,113,91
70661,Krupanj,6,,270,183,270,87,87,2,85,71,14
70661,Krupanj,7,,972,558,972,414,414,2,412,273,139
70661,Krupanj,8,,452,244,452,208,208,6,202,116,86
70661,Krupanj,9,,395,273,395,122,122,0,122,92,30
70661,Krupanj,10,,455,265,455,190,190,2,188,157,31
70661,Krupanj,11,,468,242,468,226,226,10,216,133,83
70661,Krupanj,12,,302,186,302,116,116,5,111,80,31
70661,Krupanj,13,,839,571,839,268,268,4,264,217,47
70661,Krupanj,14,,495,325,495,170,170,4,166,122,44
70661,Krupanj,15,,655,434,655,221,221,4,217,151,66
70661,Krupanj,16,,806,527,806,279,279,6,273,175,98
70661,Krupanj,17,,321,183,321,138,138,0,138,92,46
70661,Krupanj,18,,282,129,282,153,153,1,152,106,46
70661,Krupanj,19,,335,165,335,170,170,3,167,102,65
70661,Krupanj,20,,167,85,167,82,82,2,80,74,6
70661,Krupanj,21,,267,145,267,122,122,1,121,97,24
70661,Krupanj,22,,384,212,384,172,172,3,169,125,44
70661,Krupanj,23,,285,155,285,130,130,2,128,54,74
70661,Krupanj,24,,259,136,259,123,123,1,122,73,49
70661,Krupanj,25,,299,189,299,110,110,2,108,50,58
70661,Krupanj,26,,208,82,208,126,126,1,125,89,36
70661,Krupanj,27,,549,398,549,151,151,0,151,92,59
70661,Krupanj,28,,209,141,209,68,68,1,67,34,33
70661,Krupanj,29,,660,378,660,282,282,2,280,173,107
70661,Krupanj,30,,1137,557,1139,580,580,16,564,221,343
70661,Krupanj,31,,1247,717,1247,530,530,4,526,248,278
70661,Krupanj,32,,672,328,672,344,344,6,338,137,201
70661,Krupanj,33,,967,526,967,441,441,6,435,240,195
70670,Kruševac,1,,2230,1150,2229,1080,1080,17,1063,499,564
70670,Kruševac,2,,2330,1123,2333,1207,1207,20,1187,452,735
70670,Kruševac,3,,1638,700,1641,938,938,9,929,354,575
70670,Kruševac,4,,1212,548,1213,664,664,15,649,250,399
70670,Kruševac,5,,2270,1168,2270,1102,1102,21,1081,529,552
70670,Kruševac,6,,933,481,933,452,452,10,442,205,237
70670,Kruševac,7,,1519,848,1519,671,671,18,653,253,400
70670,Kruševac,8,,1836,891,1836,945,945,15,930,438,492
70670,Kruševac,9,,1709,794,1709,915,915,18,897,284,613
70670,Kruševac,10,,1533,629,1533,904,904,14,890,321,569
70670,Kruševac,11,,1574,722,1578,852,852,18,834,280,554
70670,Kruševac,12,,1793,806,1793,987,986,20,966,317,649
70670,Kruševac,13,,1700,708,1700,992,991,24,967,335,632
70670,Kruševac,14,,1560,704,1563,856,856,15,841,298,543
70670,Kruševac,15,,1373,580,1373,793,793,27,766,242,524
70670,Kruševac,16,,1725,778,1727,947,947,12,935,290,645
70670,Kruševac,17,,1544,706,1544,838,838,14,824,287,537
70670,Kruševac,18,,1882,956,1882,926,925,17,908,355,553
70670,Kruševac,19,,2333,1189,2334,1144,1144,19,1125,398,727
70670,Kruševac,20,,2285,1115,2286,1170,1170,17,1153,506,647
70670,Kruševac,21,,2188,1262,2189,926,926,12,914,362,552
70670,Kruševac,22,,2270,1219,2271,1051,1051,15,1036,420,616
70670,Kruševac,23,,1366,674,1366,692,692,11,681,319,362
70670,Kruševac,24,,1740,810,1742,930,930,14,916,555,361
70670,Kruševac,25,,2037,1040,2037,997,997,13,984,524,460
70670,Kruševac,26,,2423,1298,2423,1125,1125,21,1104,579,525
70670,Kruševac,27,,852,612,852,240,240,4,236,141,95
70670,Kruševac,28,,1512,682,1512,830,830,14,816,298,518
70670,Kruševac,29,,1777,848,1777,929,929,21,908,352,556
70670,Kruševac,30,,1590,778,1590,812,812,12,800,334,466
70670,Kruševac,31,,1308,691,1308,617,617,7,610,359,251
70670,Kruševac,32,,948,469,948,479,479,5,474,261,213
70670,Kruševac,33,,1295,690,1296,605,604,11,593,292,301
70670,Kruševac,34,,1158,591,1158,567,567,10,557,283,274
70670,Kruševac,35,,1650,872,1650,778,778,12,766,304,462
70670,Kruševac,36,,706,444,706,262,262,2,260,121,139
70670,Kruševac,37,,771,441,771,330,330,0,330,207,123
70670,Kruševac,38,,948,456,948,492,492,8,484,196,288
70670,Kruševac,39,,120,53,120,67,67,0,67,16,51
70670,Kruševac,40,,297,140,297,157,157,4,153,52,101
70670,Kruševac,41,,553,259,553,294,294,5,289,119,170
70670,Kruševac,42,,239,114,239,125,125,1,124,51,73
70670,Kruševac,43,,759,419,759,340,340,2,338,202,136
70670,Kruševac,44,,801,477,801,324,324,4,320,203,117
70670,Kruševac,45,,247,135,247,112,112,1,111,69,42
70670,Kruševac,46,,332,220,332,112,112,3,109,67,42
70670,Kruševac,47,,1522,916,1522,606,606,12,594,286,308
70670,Kruševac,48,,1163,754,1163,409,409,14,395,249,146
70670,Kruševac,49,,1097,688,1096,409,409,10,399,226,173
70670,Kruševac,50,,1636,892,1636,744,744,11,733,396,337
70670,Kruševac,51,,1633,934,1631,699,699,8,691,434,257
70670,Kruševac,52,,348,205,350,143,143,4,139,38,101
70670,Kruševac,53,,948,584,948,364,364,7,357,222,135
70670,Kruševac,54,,297,185,297,112,112,2,110,81,29
70670,Kruševac,55,,368,218,368,150,150,1,149,58,91
70670,Kruševac,56,,110,55,110,55,55,0,55,31,24
70670,Kruševac,57,,570,338,570,232,232,3,229,174,55
70670,Kruševac,58,,452,312,452,140,140,3,137,72,65
70670,Kruševac,59,,296,187,296,109,109,1,108,72,36
70670,Kruševac,60,,682,396,682,286,286,1,285,151,134
70670,Kruševac,61,,826,452,826,374,374,4,370,203,167
70670,Kruševac,62,,918,574,918,344,344,5,339,218,121
70670,Kruševac,63,,453,192,453,261,260,5,255,118,137
70670,Kruševac,64,,341,181,341,160,160,5,155,71,84
70670,Kruševac,65,,436,207,436,229,229,2,227,118,109
70670,Kruševac,66,,420,240,420,180,180,3,177,121,56
70670,Kruševac,67,,736,429,736,307,307,6,301,136,165
70670,Kruševac,68,,532,269,532,263,263,3,260,184,76
70670,Kruševac,69,,139,75,139,64,64,0,64,39,25
70670,Kruševac,70,,417,212,417,205,205,6,199,87,112
70670,Kruševac,71,,508,254,508,254,254,7,247,139,108
70670,Kruševac,72,,950,674,949,276,276,1,275,169,106
70670,Kruševac,73,,582,312,582,270,270,4,266,148,118
70670,Kruševac,74,,689,410,689,279,279,11,268,130,138
70670,Kruševac,75,,700,407,700,293,293,6,287,128,159
70670,Kruševac,76,,353,235,353,118,118,3,115,48,67
70670,Kruševac,77,,631,368,630,263,263,11,252,124,128
70670,Kruševac,78,,1203,640,1203,563,563,7,556,282,274
70670,Kruševac,79,,621,432,621,189,189,1,188,107,81
70670,Kruševac,80,,242,110,242,132,132,2,130,70,60
70670,Kruševac,81,,2123,1213,2121,910,910,6,904,516,388
70670,Kruševac,82,,913,455,913,458,458,6,452,239,213
70670,Kruševac,83,,1479,830,1479,649,649,21,628,272,356
70670,Kruševac,84,,1611,906,1611,705,704,9,695,363,332
70670,Kruševac,85,,533,357,533,176,176,2,174,110,64
70670,Kruševac,86,,238,142,238,96,96,3,93,47,46
70670,Kruševac,87,,459,232,459,227,227,7,220,99,121
70670,Kruševac,88,,230,150,230,80,80,0,80,45,35
70670,Kruševac,89,,302,149,302,153,153,1,152,66,86
70670,Kruševac,90,,814,395,814,419,419,4,415,166,249
70670,Kruševac,91,,237,103,237,134,134,1,133,87,46
70670,Kruševac,92,,333,194,333,139,139,4,135,43,92
70670,Kruševac,93,,722,398,722,324,324,8,316,199,117
70670,Kruševac,94,,406,252,406,154,154,3,151,100,51
70670,Kruševac,95,,351,268,351,83,83,1,82,54,28
70670,Kruševac,96,,409,196,409,213,213,3,210,141,69
70670,Kruševac,97,,330,249,330,81,81,2,79,46,33
70670,Kruševac,98,,1332,727,1333,605,605,9,596,296,300
70670,Kruševac,99,,1197,684,1197,513,513,6,507,317,190
70670,Kruševac,100,,578,297,588,281,281,4,277,156,121
70670,Kruševac,101,,158,60,158,98,98,2,96,53,43
70670,Kruševac,102,,264,113,265,151,151,0,151,50,101
70670,Kruševac,103,,615,286,615,329,329,4,325,170,155
70670,Kruševac,104,,428,256,428,172,172,1,171,104,67
70670,Kruševac,105,,100,34,100,66,66,0,66,30,36
70670,Kruševac,106,,836,469,836,367,366,8,358,147,211
70670,Kruševac,107,,550,330,550,220,220,3,217,99,118
70670,Kruševac,108,,196,110,196,86,86,1,85,32,53
70670,Kruševac,109,,327,175,327,152,152,2,150,45,105
70670,Kruševac,110,,370,220,370,150,150,2,148,60,88
70670,Kruševac,111,,703,412,703,291,291,6,285,149,136
70670,Kruševac,112,,637,339,637,298,298,5,293,154,139
70670,Kruševac,113,,333,129,333,204,204,1,203,103,100
70670,Kruševac,114,,1145,651,1144,494,494,5,489,253,236
70670,Kruševac,115,,1109,631,1109,478,478,7,471,198,273
70670,Kruševac,116,,770,496,770,274,274,6,268,72,196
70670,Kruševac,117,,119,68,119,51,51,1,50,25,25
70670,Kruševac,118,,170,93,170,77,77,0,77,32,45
70670,Kruševac,119,,819,388,819,431,431,18,413,239,174
70670,Kruševac,120,,134,36,134,98,98,2,96,38,58
70670,Kruševac,121,,120,47,120,73,73,2,71,39,32
70670,Kruševac,122,,203,88,203,115,115,2,113,36,77
70670,Kruševac,123,,185,87,185,98,98,3,95,60,35
70670,Kruševac,124,,368,183,368,185,185,3,182,96,86
70670,Kruševac,125,,182,87,181,95,95,0,95,55,40
70670,Kruševac,126,,169,62,169,107,107,2,105,57,48
70670,Kruševac,127,,149,77,149,72,72,1,71,31,40
70670,Kruševac,128,,331,157,331,174,174,3,171,100,71
70670,Kruševac,129,,1374,729,1374,645,645,6,639,329,310
70670,Kruševac,130,,920,472,920,448,448,3,445,268,177
70670,Kruševac,131,,604,297,604,307,307,2,305,150,155
70688,Kuršumlija,1,,646,428,646,218,218,3,215,130,85
70688,Kuršumlija,2,,541,333,541,208,208,2,206,116,90
70688,Kuršumlija,3,,628,413,628,215,215,6,209,148,61
70688,Kuršumlija,4,,461,239,462,222,222,3,219,126,93
70688,Kuršumlija,5,,859,515,859,344,344,4,340,239,101
70688,Kuršumlija,6,,449,295,450,154,154,1,153,115,38
70688,Kuršumlija,7,,429,250,429,179,179,1,178,105,73
70688,Kuršumlija,8,,908,529,908,379,379,3,376,253,123
70688,Kuršumlija,9,,528,320,528,208,208,0,208,157,51
70688,Kuršumlija,10,,422,250,422,172,172,1,171,130,41
70688,Kuršumlija,11,,440,224,440,216,216,3,213,108,105
70688,Kuršumlija,12,,515,278,516,237,237,3,234,136,98
70688,Kuršumlija,13,,806,435,806,371,371,4,367,197,170
70688,Kuršumlija,14,,505,266,505,239,239,0,239,107,132
70688,Kuršumlija,15,,429,196,429,233,233,5,228,122,106
70688,Kuršumlija,16,,521,255,521,266,266,4,262,131,131
70688,Kuršumlija,17,,554,315,554,239,239,1,238,138,100
70688,Kuršumlija,18,,512,279,512,233,233,4,229,119,110
70688,Kuršumlija,19,,483,253,483,230,230,3,227,169,58
70688,Kuršumlija,20,,248,143,248,105,105,0,105,75,30
70688,Kuršumlija,21,,118,71,118,47,47,2,45,41,4
70688,Kuršumlija,22,,159,98,159,61,61,2,59,41,18
70688,Kuršumlija,23,,193,130,193,63,63,1,62,21,41
70688,Kuršumlija,24,,142,73,142,69,69,4,65,49,16
70688,Kuršumlija,25,,266,187,266,79,79,1,78,56,22
70688,Kuršumlija,26,,111,87,111,24,24,0,24,15,9
70688,Kuršumlija,27,,164,101,164,63,63,0,63,40,23
70688,Kuršumlija,28,,283,174,283,109,109,0,109,84,25
70688,Kuršumlija,29,,213,154,213,59,59,1,58,45,13
70688,Kuršumlija,30,,262,197,262,65,65,0,65,44,21
70688,Kuršumlija,31,,211,133,211,78,78,2,76,28,48
70688,Kuršumlija,32,,155,117,155,38,38,0,38,28,10
70688,Kuršumlija,33,,344,230,344,114,114,1,113,76,37
70688,Kuršumlija,34,,124,68,124,56,56,0,56,33,23
70688,Kuršumlija,35,,221,93,221,128,128,2,126,88,38
70688,Kuršumlija,36,,215,107,215,108,108,2,106,87,19
70688,Kuršumlija,37,,390,290,390,100,100,2,98,60,38
70688,Kuršumlija,38,,104,82,104,22,22,1,21,15,6
70688,Kuršumlija,39,,432,324,432,108,108,0,108,89,19
70688,Kuršumlija,40,,104,47,104,57,57,2,55,20,35
70688,Kuršumlija,41,,139,36,139,103,103,1,102,23,79
70688,Kuršumlija,42,,253,196,253,57,57,0,57,46,11
70688,Kuršumlija,43,,424,236,424,188,188,2,186,109,77
70688,Kuršumlija,44,,262,126,262,136,136,0,136,96,40
70688,Kuršumlija,45,,196,121,196,75,75,1,74,58,16
70688,Kuršumlija,46,,391,276,391,115,115,0,115,95,20
70688,Kuršumlija,47,,198,109,198,89,89,0,89,74,15
70688,Kuršumlija,48,,160,93,160,67,67,0,67,53,14
70688,Kuršumlija,49,,155,57,155,98,98,3,95,52,43
70688,Kuršumlija,50,,146,66,146,80,80,1,79,66,13
70688,Kuršumlija,51,,274,184,274,90,90,1,89,59,30
70688,Kuršumlija,52,,150,87,150,63,63,0,63,43,20
70688,Kuršumlija,53,,419,218,419,201,201,4,197,139,58
70688,Kuršumlija,54,,121,72,121,49,49,0,49,29,20
70696,Kučevo,1,,281,148,281,133,133,5,128,46,82
70696,Kučevo,2,,132,55,132,77,77,2,75,41,34
70696,Kučevo,3,,643,343,643,300,300,6,294,124,170
70696,Kučevo,4,,476,190,476,286,286,5,281,140,141
70696,Kučevo,5,,578,387,578,191,191,3,188,92,96
70696,Kučevo,6,,432,257,432,175,175,5,170,91,79
70696,Kučevo,7,,487,190,487,297,297,2,295,156,139
70696,Kučevo,8,,241,107,241,134,134,0,134,88,46
70696,Kučevo,9,,372,234,372,138,138,5,133,60,73
70696,Kučevo,10,,214,105,214,109,109,4,105,66,39
70696,Kučevo,11,,271,146,271,125,125,3,122,55,67
70696,Kučevo,12,,238,129,238,109,109,1,108,35,73
70696,Kučevo,13,,590,372,589,218,218,2,216,93,123
70696,Kučevo,14,,241,132,241,109,109,0,109,29,80
70696,Kučevo,15,,434,228,434,206,206,3,203,129,74
70696,Kučevo,16,,579,219,578,360,360,3,357,183,174
70696,Kučevo,17,,150,68,150,82,82,1,81,44,37
70696,Kučevo,18,,1121,476,1121,645,645,23,622,363,259
70696,Kučevo,19,,779,389,779,390,390,14,376,194,182
70696,Kučevo,20,,1163,468,1163,695,695,15,680,364,316
70696,Kučevo,21,,1286,687,1285,599,599,5,594,320,274
70696,Kučevo,22,,439,186,438,253,253,7,246,171,75
70696,Kučevo,23,,249,100,249,149,149,2,147,71,76
70696,Kučevo,24,,179,94,179,85,85,0,85,39,46
70696,Kučevo,25,,290,142,290,148,148,1,147,82,65
70696,Kučevo,26,,333,165,333,168,168,1,167,107,60
70696,Kučevo,27,,204,120,204,84,84,1,83,48,35
70696,Kučevo,28,,473,278,473,195,195,4,191,84,107
70696,Kučevo,29,,357,209,357,148,148,3,145,72,73
70696,Kučevo,30,,613,402,613,211,211,6,205,104,101
70696,Kučevo,31,,576,365,576,211,211,2,209,85,124
70696,Kučevo,32,,477,212,477,265,265,1,264,113,151
70696,Kučevo,33,,739,438,739,301,301,3,298,174,124
70696,Kučevo,34,,329,161,329,168,168,2,166,77,89
70696,Kučevo,35,,200,95,200,105,105,4,101,52,49
70696,Kučevo,36,,818,621,818,197,197,7,190,109,81
70696,Kučevo,37,,423,211,423,212,212,5,207,99,108
70696,Kučevo,38,,311,156,311,155,155,1,154,77,77
70696,Kučevo,39,,541,281,541,260,260,6,254,138,116
70696,Kučevo,40,,323,173,324,150,150,3,147,80,67
70696,Kučevo,41,,500,284,500,216,212,1,211,101,110
70696,Kučevo,42,,393,240,395,153,153,5,148,78,70
70700,Lajkovac,1,,547,254,547,293,293,5,288,138,150
70700,Lajkovac,2,,607,207,607,400,400,9,391,146,245
70700,Lajkovac,3,,276,133,276,143,143,4,139,65,74
70700,Lajkovac,4,,250,115,250,135,135,6,129,63,66
70700,Lajkovac,5,,497,222,497,275,275,6,269,106,163
70700,Lajkovac,6,,388,135,388,253,253,15,238,87,151
70700,Lajkovac,7,,561,233,561,328,328,9,319,130,189
70700,Lajkovac,8,,528,207,528,321,321,9,312,117,195
70700,Lajkovac,9,,326,120,326,206,206,5,201,88,113
70700,Lajkovac,10,,162,57,162,105,105,6,99,56,43
70700,Lajkovac,11,,358,133,358,225,225,5,220,112,108
70700,Lajkovac,12,,312,173,312,139,139,0,139,56,83
70700,Lajkovac,13,,171,59,171,112,112,0,112,40,72
70700,Lajkovac,14,,285,114,285,171,171,5,166,92,74
70700,Lajkovac,15,,346,138,346,208,208,2,206,90,116
70700,Lajkovac,16,,204,70,204,134,134,2,132,64,68
70700,Lajkovac,17,,546,261,546,285,285,3,282,168,114
70700,Lajkovac,18,,364,165,364,199,199,5,194,91,103
70700,Lajkovac,19,,277,92,277,185,185,8,177,55,122
70700,Lajkovac,20,,489,226,489,263,263,5,258,141,117
70700,Lajkovac,21,,342,127,342,215,215,7,208,62,146
70700,Lajkovac,22,,315,186,315,129,129,2,127,95,32
70700,Lajkovac,23,,102,41,102,61,61,2,59,30,29
70700,Lajkovac,24,,485,164,485,321,321,9,312,93,219
70700,Lajkovac,25,,510,229,510,281,281,7,274,136,138
70700,Lajkovac,26,,196,96,196,100,100,4,96,44,52
70700,Lajkovac,27,,295,126,295,169,169,4,165,87,78
70700,Lajkovac,28,,567,271,567,296,296,4,292,105,187
70700,Lajkovac,29,,154,83,154,71,71,1,70,52,18
70700,Lajkovac,30,,270,123,270,147,147,1,146,71,75
70700,Lajkovac,31,,387,177,387,210,210,6,204,105,99
70700,Lajkovac,32,,273,139,273,134,134,4,130,72,58
70700,Lajkovac,33,,293,142,293,151,151,0,151,68,83
70700,Lajkovac,34,,401,148,401,253,253,6,247,108,139
70700,Lajkovac,35,,538,244,538,294,294,6,288,137,151
70718,Lebane,1,,858,438,858,420,420,10,410,238,172
70718,Lebane,2,,539,268,539,271,271,1,270,172,98
70718,Lebane,3,,931,487,931,444,444,6,438,223,215
70718,Lebane,4,,970,523,970,447,447,7,440,223,217
70718,Lebane,5,,1155,781,1156,374,374,2,372,237,135
70718,Lebane,6,,1034,666,1034,368,368,2,366,244,122
70718,Lebane,7,,937,637,937,300,300,3,297,190,107
70718,Lebane,8,,717,344,717,373,373,4,369,188,181
70718,Lebane,9,,1114,681,1114,433,433,5,428,255,173
70718,Lebane,10,,642,379,642,263,263,3,260,185,75
70718,Lebane,11,,658,420,658,238,238,0,238,197,41
70718,Lebane,12,,182,79,182,103,103,0,103,79,24
70718,Lebane,13,,295,195,295,100,100,1,99,71,28
70718,Lebane,14,,342,210,342,132,132,1,131,99,32
70718,Lebane,15,,305,141,305,164,164,4,160,114,46
70718,Lebane,16,,506,331,506,175,175,3,172,131,41
70718,Lebane,17,,235,153,235,82,82,0,82,66,16
70718,Lebane,18,,208,134,208,74,74,1,73,64,9
70718,Lebane,19,,454,254,454,200,200,3,197,108,89
70718,Lebane,20,,301,217,301,84,84,2,82,71,11
70718,Lebane,21,,124,65,124,59,59,0,59,45,14
70718,Lebane,22,,192,124,192,68,68,1,67,55,12
70718,Lebane,23,,259,125,259,134,134,4,130,108,22
70718,Lebane,24,,741,438,741,303,303,3,300,237,63
70718,Lebane,25,,504,269,504,235,235,4,231,170,61
70718,Lebane,26,,279,148,279,131,131,0,131,98,33
70718,Lebane,27,,291,185,291,106,106,0,106,82,24
70718,Lebane,28,,259,154,259,105,105,0,105,70,35
70718,Lebane,29,,687,404,687,283,283,2,281,182,99
70718,Lebane,30,,702,395,702,307,307,4,303,136,167
70718,Lebane,31,,730,423,730,307,307,9,298,212,86
70718,Lebane,32,,323,197,323,126,126,1,125,103,22
70718,Lebane,33,,337,184,337,153,153,0,153,95,58
70718,Lebane,34,,394,278,394,116,116,0,116,77,39
70718,Lebane,35,,175,105,175,70,70,1,69,60,9
70718,Lebane,36,,691,402,691,289,289,5,284,215,69
70718,Lebane,37,,247,153,247,94,94,0,94,73,21
70718,Lebane,38,,118,82,118,36,36,0,36,30,6
70718,Lebane,39,,328,221,328,107,107,0,107,100,7
70718,Lebane,40,,143,84,143,59,59,0,59,40,19
70718,Lebane,41,,304,234,304,70,70,1,69,45,24
70718,Lebane,42,,110,71,110,39,39,0,39,31,8
70726,Leskovac,1,,1899,932,1899,967,967,17,950,394,556
70726,Leskovac,2,,2030,1027,2030,1003,1003,11,992,494,498
70726,Leskovac,3,,1698,773,1698,925,925,6,919,474,445
70726,Leskovac,4,,1168,570,1168,598,598,11,587,349,238
70726,Leskovac,5,,745,371,745,374,374,4,370,209,161
70726,Leskovac,6,,716,372,716,344,344,8,336,158,178
70726,Leskovac,7,,858,367,862,491,491,6,485,221,264
70726,Leskovac,8,,2437,1236,2437,1201,1197,18,1179,616,563
70726,Leskovac,9,,2236,1067,2236,1169,1169,17,1152,521,631
70726,Leskovac,10,,623,260,623,363,363,14,349,162,187
70726,Leskovac,11,,1231,590,1231,641,641,7,634,328,306
70726,Leskovac,12,,1371,608,1371,763,763,9,754,375,379
70726,Leskovac,13,,712,348,712,364,364,4,360,139,221
70726,Leskovac,14,,2188,893,2188,1295,1293,20,1273,510,763
70726,Leskovac,15,,2421,1061,2421,1360,1360,30,1330,504,826
70726,Leskovac,16,,1352,948,1352,404,403,8,395,236,159
70726,Leskovac,17,,1957,938,1957,1019,1019,20,999,490,509
70726,Leskovac,18,,1842,938,1844,904,904,20,884,467,417
70726,Leskovac,19,,502,215,502,287,287,5,282,88,194
70726,Leskovac,20,,598,231,598,367,367,10,357,149,208
70726,Leskovac,21,,567,238,567,329,329,6,323,134,189
70726,Leskovac,22,,1150,475,1150,675,675,12,663,309,354
70726,Leskovac,23,,864,407,864,457,457,6,451,187,264
70726,Leskovac,24,,722,336,722,386,386,5,381,171,210
70726,Leskovac,25,,1283,671,1283,612,612,5,607,309,298
70726,Leskovac,26,,1809,1173,1809,636,636,3,633,448,185
70726,Leskovac,27,,447,197,448,250,250,2,248,132,116
70726,Leskovac,28,,1186,599,1186,587,587,34,553,280,273
70726,Leskovac,29,,1446,772,1454,674,674,13,661,421,240
70726,Leskovac,30,,2288,1155,2288,1133,1133,25,1108,618,490
70726,Leskovac,31,,2394,1334,2394,1060,1060,31,1029,411,618
70726,Leskovac,32,,1906,1109,1906,797,797,5,792,504,288
70726,Leskovac,33,,1953,849,1953,1104,1102,14,1088,434,654
70726,Leskovac,34,,2081,1011,2081,1070,1070,18,1052,476,576
70726,Leskovac,35,,1509,758,1509,751,751,6,745,356,389
70726,Leskovac,36,,1756,1023,1756,733,733,15,718,397,321
70726,Leskovac,37,,182,96,182,86,86,0,86,85,1
70726,Leskovac,38,,111,12,111,99,99,1,98,64,34
70726,Leskovac,39,,119,42,119,77,77,0,77,56,21
70726,Leskovac,40,,114,56,114,58,58,0,58,45,13
70726,Leskovac,41,,169,72,169,97,97,0,97,76,21
70726,Leskovac,42,,303,185,303,118,118,0,118,79,39
70726,Leskovac,43,,208,117,208,91,91,0,91,53,38
70726,Leskovac,44,,382,193,382,189,189,2,187,118,69
70726,Leskovac,45,,448,234,448,214,214,1,213,127,86
70726,Leskovac,46,,361,213,361,148,148,2,146,108,38
70726,Leskovac,47,,227,150,227,77,77,0,77,45,32
70726,Leskovac,48,,445,251,445,194,194,3,191,142,49
70726,Leskovac,49,,747,494,747,253,253,4,249,162,87
70726,Leskovac,50,,404,194,404,210,210,2,208,151,57
70726,Leskovac,51,,508,280,508,228,228,2,226,185,41
70726,Leskovac,52,,250,90,250,160,160,0,160,137,23
70726,Leskovac,53,,458,319,458,139,139,0,139,99,40
70726,Leskovac,54,,499,351,499,148,148,3,145,83,62
70726,Leskovac,55,,590,360,590,230,230,5,225,139,86
70726,Leskovac,56,,252,182,252,70,70,2,68,61,7
70726,Leskovac,57,,570,389,571,181,181,3,178,120,58
70726,Leskovac,58,,872,447,868,425,425,7,418,220,198
70726,Leskovac,59,,780,417,780,363,363,2,361,265,96
70726,Leskovac,60,,524,320,524,204,204,2,202,142,60
70726,Leskovac,61,,474,323,474,151,151,0,151,130,21
70726,Leskovac,62,,579,341,579,238,238,4,234,183,51
70726,Leskovac,63,,511,276,511,235,235,2,233,174,59
70726,Leskovac,64,,535,276,535,259,259,0,259,195,64
70726,Leskovac,65,,505,252,506,253,253,5,248,155,93
70726,Leskovac,66,,671,410,671,261,261,4,257,194,63
70726,Leskovac,67,,433,221,433,212,212,3,209,160,49
70726,Leskovac,68,,187,83,187,104,104,0,104,77,27
70726,Leskovac,69,,432,247,432,185,185,5,180,120,60
70726,Leskovac,70,,380,207,390,173,173,5,168,124,44
70726,Leskovac,71,,342,169,342,173,173,5,168,116,52
70726,Leskovac,72,,478,225,478,253,253,3,250,174,76
70726,Leskovac,73,,443,240,443,203,203,2,201,121,80
70726,Leskovac,74,,309,104,309,205,205,4,201,132,69
70726,Leskovac,75,,237,120,237,117,117,5,112,71,41
70726,Leskovac,76,,504,216,504,288,288,2,286,262,24
70726,Leskovac,77,,1087,564,1087,523,523,8,515,396,119
70726,Leskovac,78,,207,96,207,111,111,0,111,103,8
70726,Leskovac,79,,465,276,465,189,189,0,189,158,31
70726,Leskovac,80,,162,71,162,91,91,0,91,62,29
70726,Leskovac,81,,368,186,368,182,182,2,180,147,33
70726,Leskovac,82,,1227,658,1227,569,569,10,559,443,116
70726,Leskovac,83,,371,233,371,138,138,0,138,103,35
70726,Leskovac,84,,719,407,719,312,312,2,310,208,102
70726,Leskovac,85,,602,408,602,194,194,4,190,149,41
70726,Leskovac,86,,251,115,251,136,136,4,132,93,39
70726,Leskovac,87,,324,179,324,145,145,0,145,134,11
70726,Leskovac,88,,558,304,558,254,254,1,253,193,60
70726,Leskovac,89,,179,86,179,93,93,1,92,81,11
70726,Leskovac,90,,232,114,232,118,118,1,117,90,27
70726,Leskovac,91,,462,268,462,194,194,0,194,163,31
70726,Leskovac,92,,1484,826,1484,658,658,11,647,479,168
70726,Leskovac,93,,392,228,392,164,164,0,164,116,48
70726,Leskovac,94,,541,325,541,216,216,2,214,155,59
70726,Leskovac,95,,679,411,679,268,268,3,265,198,67
70726,Leskovac,96,,862,549,862,313,313,3,310,253,57
70726,Leskovac,97,,578,370,578,208,208,3,205,149,56
70726,Leskovac,98,,324,216,324,108,108,2,106,83,23
70726,Leskovac,99,,482,239,482,243,243,3,240,212,28
70726,Leskovac,100,,399,175,399,224,224,4,220,167,53
70726,Leskovac,101,,547,235,547,312,312,7,305,174,131
70726,Leskovac,102,,281,107,281,174,174,1,173,119,54
70726,Leskovac,103,,291,137,291,154,154,5,149,91,58
70726,Leskovac,104,,773,360,773,413,413,4,409,218,191
70726,Leskovac,105,,707,372,707,335,335,2,333,214,119
70726,Leskovac,106,,375,216,375,159,159,1,158,104,54
70726,Leskovac,107,,404,221,404,183,183,4,179,111,68
70726,Leskovac,108,,474,217,474,257,257,4,253,175,78
70726,Leskovac,109,,528,271,531,257,257,3,254,199,55
70726,Leskovac,110,,466,264,466,202,202,4,198,151,47
70726,Leskovac,111,,647,398,647,249,249,10,239,153,86
70726,Leskovac,112,,542,321,542,221,221,0,221,163,58
70726,Leskovac,113,,506,248,506,258,258,3,255,150,105
70726,Leskovac,114,,678,379,678,299,299,3,296,201,95
70726,Leskovac,115,,618,388,618,230,230,3,227,170,57
70726,Leskovac,116,,612,317,612,295,295,10,285,191,94
70726,Leskovac,117,,958,513,958,445,445,8,437,263,174
70726,Leskovac,118,,372,179,372,193,193,7,186,114,72
70726,Leskovac,119,,366,181,366,185,185,5,180,99,81
70726,Leskovac,120,,512,366,512,146,146,1,145,113,32
70726,Leskovac,121,,123,73,124,50,50,0,50,36,14
70726,Leskovac,122,,466,261,466,205,205,2,203,149,54
70726,Leskovac,123,,422,241,422,181,181,5,176,119,57
70726,Leskovac,124,,113,69,113,44,44,1,43,42,1
70726,Leskovac,125,,256,169,256,87,87,0,87,62,25
70726,Leskovac,126,,210,79,210,131,131,0,131,91,40
70726,Leskovac,127,,601,361,601,240,240,3,237,153,84
70726,Leskovac,128,,585,325,585,260,260,3,257,200,57
70726,Leskovac,129,,713,410,713,303,303,4,299,229,70
70726,Leskovac,130,,233,65,233,168,168,0,168,128,40
70726,Leskovac,131,,343,185,343,158,158,1,157,123,34
70726,Leskovac,132,,661,257,661,404,404,2,402,273,129
70726,Leskovac,133,,204,97,204,107,107,1,106,80,26
70726,Leskovac,134,,249,148,249,101,101,0,101,67,34
70726,Leskovac,135,,422,211,422,211,211,1,210,146,64
70726,Leskovac,136,,188,61,188,127,127,4,123,89,34
70726,Leskovac,137,,164,55,164,109,109,2,107,74,33
70726,Leskovac,138,,156,93,156,63,63,2,61,44,17
70726,Leskovac,139,,339,219,339,120,120,2,118,93,25
70726,Leskovac,140,,362,232,362,130,130,4,126,104,22
70726,Leskovac,141,,483,284,483,199,199,2,197,149,48
70726,Leskovac,142,,186,41,186,145,145,0,145,132,13
70726,Leskovac,143,,399,267,399,132,132,2,130,88,42
70726,Leskovac,144,,203,90,203,113,113,0,113,72,41
70726,Leskovac,145,,266,157,266,109,109,0,109,62,47
70726,Leskovac,146,,147,64,147,83,83,0,83,52,31
70726,Leskovac,147,,658,344,658,314,314,4,310,207,103
70726,Leskovac,148,,461,179,461,282,282,2,280,119,161
70726,Leskovac,149,,560,410,560,150,150,0,150,85,65
70726,Leskovac,150,,2144,1184,2144,960,960,12,948,656,292
70726,Leskovac,151,,2133,1113,2133,1020,1020,13,1007,711,296
70726,Leskovac,152,,1110,615,1110,495,495,8,487,318,169
70726,Leskovac,153,,1277,696,1277,581,581,7,574,358,216
70726,Leskovac,154,,631,354,631,277,277,0,277,207,70
70726,Leskovac,155,,630,355,630,275,275,2,273,235,38
70726,Leskovac,156,,206,115,206,91,91,0,91,56,35
70726,Leskovac,157,,245,114,245,131,131,0,131,105,26
70726,Leskovac,158,,374,183,374,191,189,1,188,115,73
70726,Leskovac,159,,684,346,684,338,338,7,331,206,125
70726,Leskovac,160,,595,315,595,280,280,3,277,214,63
70726,Leskovac,161,,748,436,748,312,312,6,306,225,81
70726,Leskovac,162,,871,512,871,359,359,3,356,257,99
70726,Leskovac,163,,575,295,575,280,280,0,280,157,123
70726,Leskovac,164,,689,327,689,362,362,3,359,218,141
70726,Leskovac,165,,267,96,267,171,171,2,169,110,59
70726,Leskovac,166,,662,330,662,332,332,6,326,219,107
70726,Leskovac,167,,265,133,265,132,132,2,130,78,52
70726,Leskovac,168,,590,360,590,230,230,3,227,151,76
70726,Leskovac,169,,235,95,235,140,140,1,139,87,52
70726,Leskovac,170,,266,95,266,171,171,1,170,129,41
70726,Leskovac,171,,288,82,288,206,206,3,203,178,25
70726,Leskovac,172,,620,327,620,293,293,3,290,247,43
70726,Leskovac,173,,2018,1042,2018,976,976,17,959,485,474
70726,Leskovac,174,,929,418,929,511,511,2,509,303,206
70726,Leskovac,175,,295,131,295,164,164,6,158,83,75
70726,Leskovac,176,,290,157,290,133,133,1,132,98,34
70726,Leskovac,177,,899,496,899,403,403,6,397,227,170
70726,Leskovac,178,,606,375,606,231,231,3,228,140,88
70726,Leskovac,179,,311,159,311,152,152,2,150,126,24
70726,Leskovac,180,,191,96,191,95,95,0,95,78,17
70726,Leskovac,181,,614,393,614,221,221,3,218,128,90
70726,Leskovac,182,,647,342,647,305,305,3,302,208,94
70726,Leskovac,183,,204,120,204,84,84,3,81,59,22
70726,Leskovac,184,,126,64,126,62,62,0,62,47,15
70726,Leskovac,185,,251,174,251,77,77,1,76,60,16
70726,Leskovac,186,,133,61,132,72,72,1,71,53,18
70726,Leskovac,187,,238,153,238,85,85,3,82,67,15
70726,Leskovac,188,,148,91,148,57,57,1,56,40,16
70726,Leskovac,189,,162,84,162,78,78,3,75,71,4
70726,Leskovac,190,,140,109,140,31,31,0,31,29,2
70726,Leskovac,191,,1116,578,1116,538,537,9,528,353,175
70726,Leskovac,192,,337,220,337,117,117,0,117,86,31
70726,Leskovac,193,,156,104,156,52,52,1,51,38,13
70726,Leskovac,194,,191,87,191,104,104,7,97,79,18
70726,Leskovac,195,,154,99,154,55,55,1,54,37,17
70734,Loznica,1,,1432,859,1432,573,573,4,569,304,265
70734,Loznica,2,,659,387,659,272,272,3,269,146,123
70734,Loznica,3,,1258,811,1259,447,447,9,438,257,181
70734,Loznica,4,,1353,644,1353,709,709,14,695,326,369
70734,Loznica,5,,928,564,928,364,364,4,360,187,173
70734,Loznica,6,,847,466,847,381,381,10,371,201,170
70734,Loznica,7,,746,363,746,383,383,4,379,193,186
70734,Loznica,8,,656,283,656,373,372,5,367,240,127
70734,Loznica,9,,215,114,215,101,101,0,101,71,30
70734,Loznica,10,,185,79,185,106,106,2,104,78,26
70734,Loznica,11,,598,386,598,212,212,9,203,145,58
70734,Loznica,12,,484,300,484,184,184,0,184,131,53
70734,Loznica,13,,1030,531,1030,499,499,11,488,299,189
70734,Loznica,14,,602,380,601,222,222,5,217,120,97
70734,Loznica,15,,643,353,643,290,290,5,285,181,104
70734,Loznica,16,,444,194,444,250,250,4,246,110,136
70734,Loznica,17,,454,248,454,206,206,2,204,88,116
70734,Loznica,18,,200,87,200,113,113,1,112,67,45
70734,Loznica,19,,194,107,194,87,87,0,87,57,30
70734,Loznica,20,,1144,700,1144,444,444,2,442,282,160
70734,Loznica,21,,482,278,482,204,204,2,202,115,87
70734,Loznica,22,,380,163,380,217,217,1,216,96,120
70734,Loznica,23,,215,116,215,99,99,1,98,57,41
70734,Loznica,24,,146,63,146,83,83,0,83,56,27
70734,Loznica,25,,677,435,677,242,242,4,238,140,98
70734,Loznica,26,,540,264,540,276,276,4,272,185,87
70734,Loznica,27,,128,87,128,41,41,1,40,17,23
70734,Loznica,28,,474,276,474,198,198,2,196,95,101
70734,Loznica,29,,417,273,417,144,144,0,144,94,50
70734,Loznica,30,,1318,799,1318,519,518,4,514,320,194
70734,Loznica,31,,1017,585,1017,432,432,5,427,260,167
70734,Loznica,32,,1453,847,1453,606,606,4,602,366,236
70734,Loznica,33,,567,268,567,299,299,6,293,165,128
70734,Loznica,34,,149,91,149,58,58,0,58,24,34
70734,Loznica,35,,403,259,403,144,144,1,143,84,59
70734,Loznica,36,,445,251,445,194,194,5,189,117,72
70734,Loznica,37,,517,283,517,234,234,4,230,152,78
70734,Loznica,38,,334,215,334,119,119,1,118,80,38
70734,Loznica,39,,654,428,654,226,225,6,219,160,59
70734,Loznica,40,,332,197,332,135,135,4,131,86,45
70734,Loznica,41,,676,405,676,271,271,3,268,148,120
70734,Loznica,42,,937,505,937,432,432,8,424,250,174
70734,Loznica,43,,168,80,168,88,88,1,87,68,19
70734,Loznica,44,,915,465,915,450,450,8,442,192,250
70734,Loznica,45,,1448,778,1448,670,670,11,659,389,270
70734,Loznica,46,,1067,642,1067,425,425,6,419,239,180
70734,Loznica,47,,888,469,888,419,419,7,412,201,211
70734,Loznica,48,,862,401,862,461,461,17,444,193,251
70734,Loznica,49,,1085,613,1085,472,472,11,461,241,220
70734,Loznica,50,,1152,635,1152,517,517,7,510,336,174
70734,Loznica,51,,1905,969,1909,936,936,16,920,387,533
70734,Loznica,52,,1958,1058,1958,900,900,20,880,379,501
70734,Loznica,53,,1927,938,1927,989,989,17,972,341,631
70734,Loznica,54,,1659,1000,1659,659,659,10,649,315,334
70734,Loznica,55,,1763,970,1763,793,793,18,775,335,440
70734,Loznica,56,,1205,569,1205,636,636,15,621,289,332
70734,Loznica,57,,1164,604,1165,560,560,21,539,242,297
70734,Loznica,58,,1198,570,1198,628,628,12,616,243,373
70734,Loznica,59,,777,427,777,350,350,7,343,136,207
70734,Loznica,60,,2060,1146,2060,914,914,20,894,381,513
70734,Loznica,61,,692,358,692,334,334,4,330,204,126
70734,Loznica,62,,1081,535,1081,546,546,8,538,302,236
70734,Loznica,63,,1696,882,1696,814,814,11,803,455,348
70734,Loznica,64,,1649,878,1649,771,771,9,762,435,327
70734,Loznica,65,,812,410,812,402,402,10,392,237,155
70734,Loznica,66,,1119,578,1119,541,541,9,532,312,220
70734,Loznica,67,,271,183,271,88,88,2,86,53,33
70734,Loznica,68,,1123,651,1123,472,472,9,463,245,218
70734,Loznica,69,,602,354,602,248,248,9,239,182,57
70734,Loznica,70,,806,388,806,418,418,12,406,303,103
70734,Loznica,71,,485,261,485,224,224,2,222,137,85
70734,Loznica,72,,310,164,309,146,146,1,145,74,71
70734,Loznica,73,,831,465,831,366,366,10,356,270,86
70734,Loznica,74,,775,428,775,347,347,3,344,241,103
70734,Loznica,75,,358,231,358,127,127,3,124,83,41
70734,Loznica,76,,832,572,832,260,260,2,258,157,101
70734,Loznica,77,,920,469,920,451,451,3,448,307,141
70734,Loznica,78,,288,131,288,157,157,4,153,93,60
70734,Loznica,79,,150,66,150,84,84,1,83,51,32
70734,Loznica,80,,1202,789,1202,413,413,7,406,221,185
70734,Loznica,81,,392,274,392,118,118,0,118,76,42
70734,Loznica,82,,274,158,274,116,116,2,114,69,45
70734,Loznica,83,,599,325,599,274,274,9,265,164,101
70734,Loznica,84,,1053,624,1053,429,428,6,422,249,173
70734,Loznica,85,,703,385,703,318,318,2,316,149,167
70734,Loznica,86,,283,123,283,160,160,1,159,91,68
70734,Loznica,87,,215,105,215,110,110,1,109,75,34
70734,Loznica,88,,834,483,834,351,351,3,348,163,185
70734,Loznica,89,,2326,1339,2326,987,987,18,969,523,446
70742,Lučani,1,,153,86,153,67,67,0,67,23,44
70742,Lučani,2,,376,268,376,108,108,0,108,52,56
70742,Lučani,3,,217,152,217,65,65,0,65,29,36
70742,Lučani,4,,499,284,499,215,215,0,215,95,120
70742,Lučani,5,,337,204,337,133,132,2,130,63,67
70742,Lučani,6,,193,106,193,87,87,2,85,43,42
70742,Lučani,7,,332,195,332,137,137,1,136,89,47
70742,Lučani,8,,452,301,452,151,151,1,150,89,61
70742,Lučani,9,,344,233,344,111,111,1,110,73,37
70742,Lučani,10,,173,68,173,105,105,0,105,80,25
70742,Lučani,11,,103,39,103,64,64,1,63,49,14
70742,Lučani,12,,182,142,182,40,40,2,38,24,14
70742,Lučani,13,,173,127,173,46,46,1,45,24,21
70742,Lučani,14,,340,247,340,93,93,0,93,55,38
70742,Lučani,15,,289,191,289,98,98,0,98,51,47
70742,Lučani,16,,520,256,520,264,264,6,258,124,134
70742,Lučani,17,,414,240,414,174,174,5,169,85,84
70742,Lučani,18,,334,174,334,160,160,6,154,55,99
70742,Lučani,19,,426,271,426,155,155,2,153,66,87
70742,Lučani,20,,534,363,534,171,171,3,168,71,97
70742,Lučani,21,,784,356,784,428,428,11,417,168,249
70742,Lučani,22,,537,361,537,176,176,1,175,62,113
70742,Lučani,23,,338,197,338,141,141,2,139,68,71
70742,Lučani,24,,241,102,241,139,139,1,138,101,37
70742,Lučani,25,,356,224,356,132,132,0,132,66,66
70742,Lučani,26,,225,100,225,125,125,6,119,73,46
70742,Lučani,27,,154,79,154,75,75,2,73,27,46
70742,Lučani,28,,183,100,183,83,83,1,82,20,62
70742,Lučani,29,,206,98,206,108,108,3,105,38,67
70742,Lučani,30,,245,144,245,101,101,1,100,54,46
70742,Lučani,31,,218,131,218,87,87,2,85,43,42
70742,Lučani,32,,291,136,291,155,155,3,152,94,58
70742,Lučani,33,,324,135,324,189,189,2,187,115,72
70742,Lučani,34,,593,396,593,197,197,1,196,90,106
70742,Lučani,35,,497,267,497,230,230,2,228,97,131
70742,Lučani,36,,144,48,144,96,96,6,90,37,53
70742,Lučani,37,,440,215,441,225,225,4,221,106,115
70742,Lučani,38,,206,121,206,85,85,1,84,37,47
70742,Lučani,39,,182,114,182,68,68,0,68,32,36
70742,Lučani,40,,118,63,118,55,55,1,54,15,39
70742,Lučani,41,,227,115,227,112,112,0,112,76,36
70742,Lučani,42,,601,347,602,254,254,2,252,101,151
70742,Lučani,43,,498,281,499,217,216,2,214,60,154
70742,Lučani,44,,655,317,656,338,338,2,336,105,231
70742,Lučani,45,,317,175,317,142,142,2,140,35,105
70742,Lučani,46,,395,225,395,170,170,4,166,35,131
70742,Lučani,47,,542,284,542,258,258,8,250,50,200
70742,Lučani,48,,455,318,456,137,137,4,133,50,83
70742,Lučani,49,,153,62,153,91,91,1,90,44,46
70742,Lučani,50,,289,162,289,127,127,2,125,57,68
70742,Lučani,51,,301,175,301,126,126,3,123,64,59
70742,Lučani,52,,432,262,432,170,170,2,168,64,104
70742,Lučani,53,,535,345,535,190,190,2,188,81,107
70742,Lučani,54,,233,128,233,105,105,2,103,45,58
70742,Lučani,55,,251,140,251,111,111,1,110,54,56
70742,Lučani,56,,184,112,184,72,72,0,72,54,18
70742,Lučani,57,,190,95,190,95,95,1,94,34,60
70742,Lučani,58,,513,336,513,177,177,3,174,87,87
70769,ljig,1,,486,242,486,244,244,3,241,91,150
70769,ljig,2,,393,176,393,217,217,8,209,98,111
70769,ljig,3,,490,260,490,230,230,4,226,79,147
70769,ljig,4,,226,83,226,143,143,8,135,61,74
70769,ljig,5,,422,175,422,247,247,7,240,85,155
70769,ljig,6,,308,127,308,181,181,1,180,63,117
70769,ljig,7,,273,113,273,160,160,1,159,49,110
70769,ljig,8,,306,171,306,135,135,4,131,66,65
70769,ljig,9,,248,124,248,124,124,4,120,55,65
70769,ljig,10,,352,188,352,164,164,7,157,45,112
70769,ljig,11,,301,140,301,161,161,2,159,65,94
70769,ljig,12,,386,180,386,206,206,9,197,74,123
70769,ljig,13,,381,213,381,168,168,0,168,76,92
70769,ljig,14,,355,150,355,205,205,1,204,68,136
70769,ljig,15,,230,81,230,149,149,1,148,87,61
70769,ljig,16,,299,158,299,141,141,4,137,57,80
70769,ljig,17,,246,108,246,138,138,8,130,73,57
70769,ljig,18,,726,296,726,430,430,8,422,215,207
70769,ljig,19,,738,287,738,451,451,18,433,203,230
70769,ljig,20,,415,181,415,234,234,10,224,100,124
70769,ljig,21,,608,232,608,376,376,11,365,160,205
70769,ljig,22,,161,70,161,91,91,3,88,73,15
70769,ljig,23,,498,218,498,280,280,9,271,115,156
70769,ljig,24,,174,74,174,100,100,0,100,52,48
70769,ljig,25,,419,206,419,213,213,7,206,87,119
70769,ljig,26,,237,78,237,159,159,1,158,70,88
70769,ljig,27,,325,163,325,162,162,1,161,66,95
70769,ljig,28,,328,125,328,203,203,4,199,116,83
70769,ljig,29,,287,100,287,187,187,3,184,85,99
70769,ljig,30,,413,228,413,185,185,2,183,68,115
70777,ljubovija,1,,888,391,888,497,497,9,488,197,291
70777,ljubovija,2,,504,223,504,281,281,3,278,107,171
70777,ljubovija,3,,741,366,741,375,375,5,370,221,149
70777,ljubovija,4,,864,396,864,468,468,11,457,241,216
70777,ljubovija,5,,258,109,258,149,149,5,144,95,49
70777,ljubovija,6,,324,164,324,160,160,8,152,80,72
70777,ljubovija,7,,277,206,277,71,71,1,70,22,48
70777,ljubovija,8,,497,246,497,251,251,5,246,124,122
70777,ljubovija,9,,185,84,185,101,101,6,95,54,41
70777,ljubovija,10,,255,164,255,91,91,3,88,63,25
70777,ljubovija,11,,496,326,496,170,170,3,167,103,64
70777,ljubovija,12,,262,141,262,121,121,1,120,90,30
70777,ljubovija,13,,347,265,347,82,82,5,77,59,18
70777,ljubovija,14,,268,172,268,96,96,0,96,68,28
70777,ljubovija,15,,745,447,745,298,298,1,297,177,120
70777,ljubovija,16,,849,609,849,240,240,4,236,174,62
70777,ljubovija,17,,310,161,310,149,149,0,149,68,81
70777,ljubovija,18,,202,106,202,96,96,1,95,72,23
70777,ljubovija,19,,522,297,522,225,225,3,222,149,73
70777,ljubovija,20,,233,132,233,101,101,0,101,60,41
70777,ljubovija,21,,235,108,235,127,127,1,126,89,37
70777,ljubovija,22,,219,135,219,84,84,4,80,41,39
70777,ljubovija,23,,323,189,323,134,134,1,133,96,37
70777,ljubovija,24,,291,166,291,125,125,1,124,59,65
70777,ljubovija,25,,471,290,471,181,181,4,177,132,45
70777,ljubovija,26,,226,129,226,97,97,3,94,51,43
70777,ljubovija,27,,243,138,243,105,104,0,104,59,45
70777,ljubovija,28,,359,193,359,166,166,3,163,109,54
70777,ljubovija,29,,334,127,334,207,207,2,205,113,92
70777,ljubovija,30,,340,173,340,167,167,7,160,83,77
70777,ljubovija,31,,125,103,125,22,22,0,22,19,3
70777,ljubovija,32,,183,92,183,91,91,1,90,47,43
70777,ljubovija,33,,155,81,155,74,74,1,73,50,23
70777,ljubovija,34,,232,125,232,107,107,0,107,68,39
70777,ljubovija,35,,132,71,132,61,61,0,61,45,16
70777,ljubovija,36,,101,75,101,26,26,1,25,12,13
70777,ljubovija,37,,109,57,109,52,52,1,51,22,29
70785,Majdanpek,1,,486,279,486,207,207,1,206,121,85
70785,Majdanpek,2,,376,213,376,163,163,3,160,57,103
70785,Majdanpek,3,,358,209,358,149,149,2,147,74,73
70785,Majdanpek,4,,540,304,540,236,236,5,231,101,130
70785,Majdanpek,5,,513,291,513,222,222,5,217,66,151
70785,Majdanpek,6,,468,263,468,205,205,6,199,79,120
70785,Majdanpek,7,,307,174,307,133,133,2,131,46,85
70785,Majdanpek,8,,513,269,513,244,244,3,241,93,148
70785,Majdanpek,9,,456,240,456,216,216,1,215,98,117
70785,Majdanpek,10,,505,300,505,205,205,6,199,78,121
70785,Majdanpek,11,,534,340,534,194,194,5,189,88,101
70785,Majdanpek,12,,806,499,806,307,307,4,303,107,196
70785,Majdanpek,13,,488,288,488,200,200,2,198,81,117
70785,Majdanpek,14,,667,395,667,272,272,2,270,96,174
70785,Majdanpek,15,,676,422,676,254,254,4,250,85,165
70785,Majdanpek,16,,725,405,725,320,320,2,318,122,196
70785,Majdanpek,17,,580,268,580,312,312,10,302,151,151
70785,Majdanpek,18,,338,178,338,160,160,2,158,81,77
70785,Majdanpek,19,,583,306,583,277,277,4,273,133,140
70785,Majdanpek,20,,496,271,496,225,225,5,220,89,131
70785,Majdanpek,21,,511,345,511,166,166,1,165,99,66
70785,Majdanpek,22,,639,342,639,297,297,6,291,163,128
70785,Majdanpek,23,,589,308,589,281,281,4,277,171,106
70785,Majdanpek,24,,217,137,217,80,80,0,80,53,27
70785,Majdanpek,25,,450,252,450,198,198,0,198,86,112
70785,Majdanpek,26,,426,296,426,130,130,0,130,60,70
70785,Majdanpek,27,,402,244,402,158,158,1,157,72,85
70785,Majdanpek,28,,280,188,280,92,92,3,89,48,41
70785,Majdanpek,29,,510,296,510,214,214,4,210,93,117
70785,Majdanpek,30,,371,259,371,112,112,1,111,45,66
70785,Majdanpek,31,,668,351,668,317,317,6,311,170,141
70785,Majdanpek,32,,422,209,422,213,213,9,204,93,111
70785,Majdanpek,33,,257,168,257,89,89,2,87,54,33
70785,Majdanpek,34,,226,139,226,87,87,0,87,64,23
70785,Majdanpek,35,,434,261,434,173,173,4,169,135,34
70785,Majdanpek,36,,574,303,574,271,271,5,266,180,86
70785,Majdanpek,37,,541,238,541,303,303,6,297,114,183
70785,Majdanpek,38,,540,243,540,297,297,6,291,121,170
70785,Majdanpek,39,,520,259,520,261,261,6,255,99,156
70785,Majdanpek,40,,547,275,547,272,272,1,271,160,111
70785,Majdanpek,41,,414,204,414,210,210,4,206,138,68
70793,Mali Zvornik,1,,338,143,338,195,195,2,193,75,118
70793,Mali Zvornik,2,,506,242,506,264,264,4,260,162,98
70793,Mali Zvornik,3,,482,245,482,237,237,4,233,155,78
70793,Mali Zvornik,4,,573,249,573,324,324,8,316,204,112
70793,Mali Zvornik,5,,403,212,403,191,191,0,191,99,92
70793,Mali Zvornik,6,,399,241,399,158,158,4,154,95,59
70793,Mali Zvornik,7,,383,174,383,209,209,1,208,131,77
70793,Mali Zvornik,8,,370,227,370,143,143,2,141,77,64
70793,Mali Zvornik,9,,300,132,300,168,168,3,165,82,83
70793,Mali Zvornik,10,,706,385,706,321,321,5,316,184,132
70793,Mali Zvornik,11,,239,129,239,110,110,1,109,84,25
70793,Mali Zvornik,12,,541,320,541,221,221,3,218,105,113
70793,Mali Zvornik,13,,367,245,367,122,122,2,120,9,111
70793,Mali Zvornik,14,,372,191,372,181,181,1,180,113,67
70793,Mali Zvornik,15,,531,299,531,232,231,2,229,153,76
70793,Mali Zvornik,16,,417,220,417,197,197,0,197,89,108
70793,Mali Zvornik,17,,546,308,546,238,238,3,235,117,118
70793,Mali Zvornik,18,,641,312,641,329,329,5,324,164,160
70793,Mali Zvornik,19,,435,228,435,207,207,1,206,111,95
70793,Mali Zvornik,20,,547,323,547,224,224,12,212,86,126
70793,Mali Zvornik,21,,204,127,204,77,77,2,75,52,23
70793,Mali Zvornik,22,,144,39,144,105,105,0,105,72,33
70793,Mali Zvornik,23,,195,122,195,73,73,0,73,53,20
70793,Mali Zvornik,24,,346,196,346,150,150,1,149,94,55
70793,Mali Zvornik,25,,399,181,399,218,218,1,217,152,65
70793,Mali Zvornik,26,,100,40,100,60,60,0,60,51,9
70793,Mali Zvornik,27,,206,116,206,90,90,0,90,79,11
70793,Mali Zvornik,28,,633,331,633,302,302,2,300,190,110
70793,Mali Zvornik,29,,106,61,106,45,45,2,43,31,12
70807,Malo Crniće,1,,184,112,184,72,72,1,71,41,30
70807,Malo Crniće,2,,535,200,535,335,335,10,325,218,107
70807,Malo Crniće,3,,619,349,619,270,270,4,266,69,197
70807,Malo Crniće,4,,592,369,592,223,223,6,217,96,121
70807,Malo Crniće,5,,500,292,500,208,208,1,207,60,147
70807,Malo Crniće,6,,453,278,453,175,175,4,171,74,97
70807,Malo Crniće,7,,751,491,751,260,260,1,259,146,113
70807,Malo Crniće,8,,560,339,560,221,221,2,219,121,98
70807,Malo Crniće,9,,286,183,286,103,103,1,102,52,50
70807,Malo Crniće,10,,467,244,467,223,223,7,216,121,95
70807,Malo Crniće,11,,594,390,594,204,204,1,203,107,96
70807,Malo Crniće,12,,558,343,558,215,215,1,214,123,91
70807,Malo Crniće,13,,316,199,316,117,117,3,114,49,65
70807,Malo Crniće,14,,654,347,654,307,307,4,303,124,179
70807,Malo Crniće,15,,464,354,464,110,110,3,107,58,49
70807,Malo Crniće,16,,372,178,372,194,194,6,188,107,81
70807,Malo Crniće,17,,454,253,454,201,201,5,196,129,67
70807,Malo Crniće,18,,335,212,335,123,123,0,123,68,55
70807,Malo Crniće,19,,416,239,416,177,177,0,177,100,77
70807,Malo Crniće,20,,569,404,569,165,165,1,164,89,75
70807,Malo Crniće,21,,732,501,732,231,231,2,229,101,128
70807,Malo Crniće,22,,706,499,706,207,207,3,204,80,124
70807,Malo Crniće,23,,525,354,525,171,171,3,168,119,49
70807,Malo Crniće,24,,483,328,483,155,155,1,154,87,67
70807,Malo Crniće,25,,489,251,489,238,238,3,235,86,149
70807,Malo Crniće,26,,499,358,499,141,141,3,138,75,63
70807,Malo Crniće,27,,600,399,600,201,201,3,198,73,125
70807,Malo Crniće,28,,579,412,579,167,167,4,163,72,91
70807,Malo Crniće,29,,141,87,141,54,54,0,54,33,21
70815,Medveđa,1,,1365,809,1365,556,556,14,542,294,248
70815,Medveđa,2,,1204,762,1204,442,442,8,434,225,209
70815,Medveđa,3,,269,166,269,103,102,1,101,86,15
70815,Medveđa,4,,232,146,232,86,86,0,86,78,8
70815,Medveđa,5,,149,86,149,63,63,0,63,51,12
70815,Medveđa,6,,100,59,100,41,41,0,41,38,3
70815,Medveđa,7,,335,167,335,168,168,5,163,106,57
70815,Medveđa,8,,450,236,450,214,214,2,212,133,79
70815,Medveđa,9,,338,183,338,155,155,1,154,91,63
70815,Medveđa,10,,115,52,115,63,63,0,63,46,17
70815,Medveđa,11,,343,157,343,186,186,2,184,86,98
70815,Medveđa,12,,316,247,316,69,69,0,69,42,27
70815,Medveđa,13,,214,202,214,12,12,1,11,3,8
70815,Medveđa,14,,649,588,649,61,61,0,61,1,60
70815,Medveđa,15,,149,123,149,26,26,0,26,18,8
70815,Medveđa,16,,100,65,100,35,35,0,35,30,5
70815,Medveđa,17,,190,115,190,75,75,2,73,48,25
70815,Medveđa,18,,194,121,194,73,73,1,72,57,15
70815,Medveđa,19,,108,47,108,61,61,1,60,42,18
70815,Medveđa,20,,115,65,115,50,50,1,49,46,3
70815,Medveđa,21,,143,90,143,53,53,0,53,40,13
70815,Medveđa,22,,206,122,206,84,84,0,84,62,22
70815,Medveđa,23,,510,372,510,138,138,0,138,93,45
70815,Medveđa,24,,525,487,525,38,38,0,38,18,20
70815,Medveđa,25,,676,631,676,45,45,0,45,0,45
70815,Medveđa,26,,333,273,333,60,60,0,60,43,17
70815,Medveđa,27,,112,86,112,26,26,0,26,18,8
70815,Medveđa,28,,296,280,296,16,16,3,13,3,10
70815,Medveđa,29,,100,67,100,33,33,0,33,14,19
70815,Medveđa,30,,105,81,105,24,24,1,23,14,9
70823,Merošina,1,,309,187,309,122,122,1,121,93,28
70823,Merošina,2,,329,169,329,160,160,1,159,150,9
70823,Merošina,3,,365,161,366,204,204,6,198,124,74
70823,Merošina,4,,437,265,437,172,172,1,171,148,23
70823,Merošina,5,,478,245,478,233,233,0,233,195,38
70823,Merošina,6,,437,283,437,154,154,0,154,134,20
70823,Merošina,7,,326,185,326,141,141,0,141,88,53
70823,Merošina,8,,299,142,299,157,157,3,154,117,37
70823,Merošina,9,,456,338,456,118,118,3,115,75,40
70823,Merošina,10,,487,301,487,186,186,2,184,145,39
70823,Merošina,11,,395,191,395,204,204,3,201,130,71
70823,Merošina,12,,505,246,505,259,259,1,258,207,51
70823,Merošina,13,,442,260,442,182,182,0,182,108,74
70823,Merošina,14,,197,87,197,110,110,3,107,73,34
70823,Merošina,15,,205,67,205,138,138,2,136,106,30
70823,Merošina,16,,258,123,258,135,135,0,135,112,23
70823,Merošina,17,,125,33,125,92,92,0,92,70,22
70823,Merošina,18,,218,120,218,98,98,2,96,72,24
70823,Merošina,19,,140,49,140,91,91,2,89,68,21
70823,Merošina,20,,389,234,389,155,155,0,155,124,31
70823,Merošina,21,,409,85,409,324,324,16,308,282,26
70823,Merošina,22,,261,160,261,101,101,0,101,78,23
70823,Merošina,23,,187,56,187,131,131,3,128,122,6
70823,Merošina,24,,206,61,206,145,145,2,143,130,13
70823,Merošina,25,,397,174,397,223,223,0,223,172,51
70823,Merošina,26,,216,73,216,143,143,0,143,107,36
70823,Merošina,27,,186,78,186,108,108,3,105,74,31
70823,Merošina,28,,246,145,246,101,101,2,99,66,33
70823,Merošina,29,,264,138,264,126,126,0,126,76,50
70823,Merošina,30,,271,134,271,137,137,2,135,116,19
70823,Merošina,31,,306,138,306,168,168,3,165,139,26
70823,Merošina,32,,569,327,569,242,242,3,239,158,81
70823,Merošina,33,,354,196,354,158,158,0,158,79,79
70823,Merošina,34,,289,181,289,108,108,1,107,77,30
70823,Merošina,35,,127,68,127,59,59,0,59,35,24
70823,Merošina,36,,294,137,294,157,157,3,154,93,61
70823,Merošina,37,,268,118,268,150,150,2,148,118,30
70823,Merošina,38,,328,106,328,222,222,0,222,198,24
70831,Mionica,1,,580,204,580,376,376,7,369,137,232
70831,Mionica,2,,759,327,759,432,432,8,424,164,260
70831,Mionica,3,,554,281,554,273,273,4,269,129,140
70831,Mionica,4,,643,349,643,294,294,5,289,123,166
70831,Mionica,5,,484,220,484,264,264,2,262,118,144
70831,Mionica,6,,460,258,460,202,202,3,199,80,119
70831,Mionica,7,,150,55,150,95,95,5,90,34,56
70831,Mionica,8,,333,161,333,172,172,2,170,66,104
70831,Mionica,9,,367,160,367,207,207,7,200,101,99
70831,Mionica,10,,118,54,118,64,64,0,64,36,28
70831,Mionica,11,,352,211,352,141,141,3,138,50,88
70831,Mionica,12,,343,186,343,157,157,5,152,65,87
70831,Mionica,13,,166,71,166,95,95,0,95,41,54
70831,Mionica,14,,125,56,125,69,69,0,69,27,42
70831,Mionica,15,,185,94,185,91,91,2,89,42,47
70831,Mionica,16,,489,197,489,292,292,17,275,189,86
70831,Mionica,17,,235,104,235,131,131,3,128,51,77
70831,Mionica,18,,100,46,100,54,54,0,54,28,26
70831,Mionica,19,,394,218,394,176,176,2,174,67,107
70831,Mionica,20,,361,192,361,169,169,1,168,63,105
70831,Mionica,21,,347,186,347,161,161,3,158,119,39
70831,Mionica,22,,253,79,253,174,174,2,172,93,79
70831,Mionica,23,,255,110,255,145,145,1,144,64,80
70831,Mionica,24,,233,111,233,122,122,0,122,75,47
70831,Mionica,25,,387,206,387,181,181,1,180,98,82
70831,Mionica,26,,217,134,217,83,83,0,83,46,37
70831,Mionica,27,,406,222,406,184,184,4,180,71,109
70831,Mionica,28,,264,122,264,142,142,1,141,77,64
70831,Mionica,29,,595,362,595,233,233,3,230,80,150
70831,Mionica,30,,261,109,261,152,152,3,149,79,70
70831,Mionica,31,,258,119,258,139,139,3,136,74,62
70831,Mionica,32,,380,189,380,191,191,3,188,71,117
70831,Mionica,33,,362,184,362,178,178,1,177,59,118
70831,Mionica,34,,198,78,198,120,120,12,108,53,55
70831,Mionica,35,,211,95,211,116,116,0,116,48,68
70831,Mionica,36,,293,120,293,173,173,3,170,83,87
70831,Mionica,37,,182,68,182,114,114,0,114,44,70
70831,Mionica,38,,334,213,334,121,121,4,117,48,69
70831,Mionica,39,,194,131,194,63,63,0,63,22,41
70840,Negotin,1,,890,578,890,312,312,0,312,156,156
70840,Negotin,2,,984,571,984,413,413,11,402,187,215
70840,Negotin,3,,767,400,768,367,367,9,358,139,219
70840,Negotin,4,,804,432,804,372,371,13,358,130,228
70840,Negotin,5,,726,421,727,305,305,3,302,149,153
70840,Negotin,6,,580,287,580,293,293,4,289,113,176
70840,Negotin,7,,801,454,801,347,347,7,340,131,209
70840,Negotin,8,,1094,635,1094,459,459,6,453,188,265
70840,Negotin,9,,881,424,881,457,457,5,452,160,292
70840,Negotin,10,,716,414,716,302,302,3,299,163,136
70840,Negotin,11,,1770,1077,1770,693,693,7,686,241,445
70840,Negotin,12,,1068,590,1068,478,478,4,474,228,246
70840,Negotin,13,,768,372,768,396,396,4,392,116,276
70840,Negotin,14,,736,389,736,347,347,6,341,100,241
70840,Negotin,15,,857,393,857,464,464,2,462,126,336
70840,Negotin,16,,923,509,923,414,414,7,407,188,219
70840,Negotin,17,,957,560,957,397,395,3,392,170,222
70840,Negotin,18,,385,229,385,156,156,4,152,38,114
70840,Negotin,19,,280,143,280,137,137,2,135,69,66
70840,Negotin,20,,605,404,605,201,201,2,199,112,87
70840,Negotin,21,,595,381,595,214,214,5,209,109,100
70840,Negotin,22,,535,338,535,197,197,2,195,85,110
70840,Negotin,23,,184,75,184,109,109,3,106,65,41
70840,Negotin,24,,801,544,801,257,257,0,257,110,147
70840,Negotin,25,,301,192,301,109,109,0,109,39,70
70840,Negotin,26,,740,575,740,165,165,2,163,81,82
70840,Negotin,27,,568,423,568,145,145,3,142,68,74
70840,Negotin,28,,498,382,498,116,116,2,114,56,58
70840,Negotin,29,,639,491,639,148,148,2,146,67,79
70840,Negotin,30,,691,464,691,227,227,5,222,84,138
70840,Negotin,31,,706,478,706,228,228,2,226,98,128
70840,Negotin,32,,740,502,740,238,238,2,236,98,138
70840,Negotin,33,,723,504,723,219,219,5,214,113,101
70840,Negotin,34,,511,320,511,191,191,0,191,87,104
70840,Negotin,35,,403,231,403,172,172,3,169,88,81
70840,Negotin,36,,617,431,617,186,186,3,183,91,92
70840,Negotin,37,,631,454,631,177,177,3,174,91,83
70840,Negotin,38,,631,449,631,182,182,7,175,79,96
70840,Negotin,39,,453,285,453,168,168,4,164,60,104
70840,Negotin,40,,423,327,423,96,96,3,93,37,56
70840,Negotin,41,,287,207,287,80,80,3,77,45,32
70840,Negotin,42,,720,522,720,198,198,7,191,90,101
70840,Negotin,43,,673,462,673,211,211,2,209,115,94
70840,Negotin,44,,447,311,447,136,136,10,126,50,76
70840,Negotin,45,,596,402,596,194,194,3,191,61,130
70840,Negotin,46,,885,583,885,302,302,7,295,101,194
70840,Negotin,47,,695,472,695,223,223,1,222,94,128
70840,Negotin,48,,252,207,252,45,45,0,45,31,14
70840,Negotin,49,,375,189,375,186,186,2,184,77,107
70840,Negotin,50,,554,317,554,237,237,5,232,138,94
70840,Negotin,51,,541,350,541,191,191,5,186,99,87
70840,Negotin,52,,591,328,591,263,263,4,259,158,101
70840,Negotin,53,,562,399,562,163,163,2,161,49,112
70840,Negotin,54,,780,562,781,218,218,3,215,76,139
70840,Negotin,55,,719,464,719,255,255,2,253,100,153
70840,Negotin,56,,312,142,312,170,170,3,167,83,84
70840,Negotin,57,,403,254,403,149,149,4,145,57,88
70840,Negotin,58,,160,69,160,91,91,4,87,45,42
70840,Negotin,59,,725,471,725,254,254,2,252,138,114
70840,Negotin,60,,600,337,600,263,263,4,259,127,132
70840,Negotin,61,,741,489,741,252,252,10,242,85,157
70840,Negotin,62,,129,44,129,85,85,2,83,46,37
70840,Negotin,63,,702,461,702,241,241,3,238,148,90
70840,Negotin,64,,277,150,277,127,127,3,124,50,74
70840,Negotin,65,,429,267,429,162,162,8,154,94,60
70840,Negotin,66,,743,600,743,143,143,1,142,65,77
70840,Negotin,67,,629,492,629,137,137,4,133,71,62
70840,Negotin,68,,630,522,630,108,108,3,105,61,44
70840,Negotin,69,,267,112,267,155,155,2,153,31,122
70840,Negotin,70,,521,292,521,229,229,4,225,115,110
70840,Negotin,71,,330,145,330,185,185,4,181,106,75
70840,Negotin,72,,878,647,878,231,231,4,227,133,94
70858,Niš,1,,1921,1030,1921,891,891,13,878,324,554
70858,Niš,2,,1702,744,1702,958,958,21,937,276,661
70858,Niš,3,,2033,1032,2031,1001,1001,20,981,320,661
70858,Niš,4,,1814,884,1814,930,930,9,921,328,593
70858,Niš,5,,1381,735,1381,646,646,7,639,298,341
70858,Niš,6,,1770,932,1770,838,838,11,827,317,510
70858,Niš,7,,1835,983,1835,852,852,5,847,324,523
70858,Niš,8,,2180,1134,2180,1046,1046,17,1029,408,621
70858,Niš,9,,1993,946,1993,1047,1046,12,1034,368,666
70858,Niš,10,,1843,978,1843,865,865,8,857,350,507
70858,Niš,11,,2008,915,2008,1093,1093,13,1080,391,689
70858,Niš,12,,1460,732,1460,728,728,10,718,295,423
70858,Niš,13,,1914,938,1914,976,976,21,955,374,581
70858,Niš,14,,1847,923,1847,924,924,8,916,298,618
70858,Niš,15,,1403,693,1403,710,710,14,696,221,475
70858,Niš,16,,1545,723,1545,822,822,14,808,302,506
70858,Niš,17,,1894,932,1894,962,962,18,944,348,596
70858,Niš,18,,1755,818,1755,937,937,14,923,319,604
70858,Niš,19,,2007,939,2007,1068,1068,14,1054,360,694
70858,Niš,20,,2239,1064,2239,1175,1175,9,1166,401,765
70858,Niš,21,,1746,810,1746,936,936,12,924,307,617
70858,Niš,22,,1991,928,1991,1063,1063,14,1049,324,725
70858,Niš,23,,2153,1100,2153,1053,1053,27,1026,362,664
70858,Niš,24,,2235,1050,2235,1185,1185,17,1168,396,772
70858,Niš,25,,1637,814,1637,823,823,12,811,264,547
70858,Niš,26,,1331,709,1331,622,622,11,611,242,369
70858,Niš,27,,1698,867,1698,831,831,12,819,292,527
70858,Niš,28,,1443,769,1444,674,674,6,668,226,442
70858,Niš,29,,1393,704,1393,689,689,6,683,266,417
70858,Niš,30,,1447,640,1447,807,807,14,793,264,529
70858,Niš,31,,1615,692,1615,923,923,17,906,286,620
70858,Niš,32,,1560,726,1560,834,834,11,823,250,573
70858,Niš,33,,1859,931,1859,928,928,27,901,307,594
70858,Niš,34,,1874,871,1874,1003,1003,14,989,318,671
70858,Niš,35,,1884,904,1884,980,980,14,966,277,689
70858,Niš,36,,1264,631,1264,633,633,10,623,176,447
70858,Niš,37,,1622,795,1622,827,827,9,818,268,550
70858,Niš,38,,1611,764,1611,847,847,12,835,253,582
70858,Niš,39,,1468,732,1468,736,736,7,729,192,537
70858,Niš,40,,1751,787,1751,964,964,17,947,288,659
70858,Niš,41,,1649,780,1649,869,869,16,853,298,555
70858,Niš,42,,1592,791,1592,801,801,9,792,245,547
70858,Niš,43,,1520,749,1520,771,771,17,754,257,497
70858,Niš,44,,1798,968,1798,830,830,10,820,291,529
70858,Niš,45,,1598,815,1598,783,783,12,771,252,519
70858,Niš,46,,1461,759,1461,702,702,6,696,260,436
70858,Niš,47,,1849,985,1859,864,864,13,851,392,459
70858,Niš,48,,1883,1095,1883,788,788,6,782,427,355
70858,Niš,49,,1449,1078,1449,371,371,6,365,232,133
70858,Niš,50,,1247,723,1247,524,524,7,517,228,289
70858,Niš,51,,1947,1111,1947,836,836,14,822,323,499
70858,Niš,52,,1862,1083,1862,779,779,7,772,396,376
70858,Niš,53,,1905,1107,1905,798,798,14,784,432,352
70858,Niš,54,,1744,945,1744,799,799,9,790,337,453
70858,Niš,55,,1900,1025,1900,875,875,26,849,421,428
70858,Niš,56,,1426,662,1426,764,764,9,755,284,471
70858,Niš,57,,2284,1175,2284,1109,1109,9,1100,457,643
70858,Niš,58,,1706,869,1706,837,837,11,826,323,503
70858,Niš,59,,1496,882,1496,614,614,9,605,268,337
70858,Niš,60,,1761,993,1761,768,767,13,754,313,441
70858,Niš,61,,1151,515,1151,636,636,9,627,195,432
70858,Niš,62,,1285,667,1285,618,618,3,615,253,362
70858,Niš,63,,1218,634,1218,584,584,6,578,221,357
70858,Niš,64,,1280,654,1276,626,626,10,616,201,415
70858,Niš,65,,1755,957,1755,798,798,11,787,310,477
70858,Niš,66,,1715,914,1715,801,801,9,792,302,490
70858,Niš,67,,1857,1016,1861,841,841,8,833,364,469
70858,Niš,68,,2121,1004,2121,1117,1117,18,1099,403,696
70858,Niš,69,,1614,895,1614,719,719,13,706,262,444
70858,Niš,70,,1742,1119,1742,623,623,5,618,314,304
70858,Niš,71,,1613,851,1613,762,762,12,750,328,422
70858,Niš,72,,1805,1094,1805,711,710,12,698,329,369
70858,Niš,73,,1528,916,1528,612,612,5,607,290,317
70858,Niš,74,,1610,1006,1610,604,604,7,597,345,252
70858,Niš,75,,1522,877,1522,645,645,8,637,305,332
70858,Niš,76,,1582,872,1583,710,710,8,702,316,386
70858,Niš,77,,1634,921,1634,713,713,11,702,362,340
70858,Niš,78,,908,592,908,316,316,2,314,191,123
70858,Niš,79,,1946,1033,1946,913,912,9,903,582,321
70858,Niš,80,,2043,1191,2043,852,851,7,844,538,306
70858,Niš,81,,687,435,687,252,252,4,248,139,109
70858,Niš,82,,742,365,742,377,377,7,370,209,161
70858,Niš,83,,260,155,260,105,105,2,103,80,23
70858,Niš,84,,657,322,657,335,335,0,335,268,67
70858,Niš,85,,1192,758,1192,434,434,4,430,325,105
70858,Niš,86,,1525,975,1525,550,550,4,546,344,202
70858,Niš,87,,1143,731,1143,412,412,2,410,246,164
70858,Niš,88,,835,500,835,335,335,4,331,216,115
70858,Niš,89,,464,267,464,197,197,6,191,127,64
70858,Niš,90,,1836,1037,1836,799,799,9,790,458,332
70858,Niš,91,,1133,640,1133,493,493,1,492,342,150
70858,Niš,92,,284,141,284,143,143,2,141,101,40
70858,Niš,93,,318,163,318,155,155,6,149,87,62
70858,Niš,94,,1280,779,1280,501,501,19,482,213,269
70858,Niš,95,,1834,1359,1834,475,473,10,463,281,182
70858,Niš,96,,1941,1190,1941,751,751,10,741,334,407
70858,Niš,97,,2485,1282,2489,1203,1203,40,1163,527,636
70858,Niš,98,,2315,1315,2315,1000,1000,18,982,483,499
70858,Niš,99,,1863,1037,1863,826,826,7,819,487,332
70858,Niš,100,,1696,1025,1696,671,671,7,664,408,256
70858,Niš,101,,1557,929,1557,628,628,7,621,368,253
70858,Niš,102,,2389,1264,2389,1125,1125,18,1107,685,422
70858,Niš,103,,1059,604,1059,455,455,5,450,308,142
70858,Niš,104,,1360,846,1360,514,514,4,510,344,166
70858,Niš,105,,1152,745,1152,407,407,10,397,269,128
70858,Niš,106,,588,285,588,303,303,1,302,182,120
70858,Niš,107,,469,273,469,196,196,3,193,141,52
70858,Niš,108,,255,139,255,116,116,1,115,96,19
70858,Niš,109,,353,205,353,148,148,1,147,101,46
70858,Niš,110,,296,175,296,121,121,2,119,74,45
70858,Niš,111,,447,258,447,189,189,1,188,134,54
70858,Niš,112,,207,97,207,110,110,0,110,61,49
70858,Niš,113,,326,219,326,107,107,0,107,65,42
70858,Niš,114,,244,153,244,91,91,2,89,67,22
70858,Niš,115,,569,366,569,203,203,4,199,123,76
70858,Niš,116,,254,120,254,134,134,0,134,76,58
70858,Niš,117,,473,240,473,233,233,8,225,147,78
70858,Niš,118,,624,331,624,293,293,8,285,190,95
70858,Niš,119,,489,280,489,209,209,5,204,124,80
70858,Niš,120,,746,463,746,283,283,2,281,203,78
70858,Niš,121,,333,210,323,123,123,2,121,68,53
70858,Niš,122,,1741,985,1741,756,756,12,744,493,251
70858,Niš,123,,915,570,915,345,345,6,339,221,118
70858,Niš,124,,1328,666,1328,662,662,6,656,259,397
70858,Niš,125,,1285,639,1285,646,646,6,640,282,358
70858,Niš,126,,1270,647,1270,623,623,9,614,290,324
70858,Niš,127,,1186,631,1185,555,555,6,549,299,250
70858,Niš,128,,1951,1019,1951,932,932,11,921,430,491
70858,Niš,129,,1740,896,1740,844,844,16,828,394,434
70858,Niš,130,,1573,854,1573,719,719,9,710,314,396
70858,Niš,131,,1889,951,1889,938,938,13,925,355,570
70858,Niš,132,,1817,949,1817,868,868,11,857,330,527
70858,Niš,133,,1737,858,1737,879,879,9,870,360,510
70858,Niš,134,,1870,964,1870,906,906,11,895,362,533
70858,Niš,135,,1994,1115,1994,879,879,12,867,330,537
70858,Niš,136,,1752,1067,1752,685,685,16,669,327,342
70858,Niš,137,,2046,1203,2046,843,843,15,828,374,454
70858,Niš,138,,1893,994,1893,899,899,11,888,357,531
70858,Niš,139,,1932,1105,1932,827,827,6,821,362,459
70858,Niš,140,,1900,1048,1900,852,852,12,840,400,440
70858,Niš,141,,1736,957,1736,779,779,10,769,368,401
70858,Niš,142,,1451,873,1451,578,578,3,575,277,298
70858,Niš,143,,1002,572,1002,430,430,5,425,284,141
70858,Niš,144,,2301,1472,2301,829,829,7,822,349,473
70858,Niš,145,,969,601,969,368,368,3,365,235,130
70858,Niš,146,,251,125,251,126,126,4,122,83,39
70858,Niš,147,,302,190,302,112,112,1,111,88,23
70858,Niš,148,,335,197,335,138,138,2,136,60,76
70858,Niš,149,,212,103,212,109,109,3,106,80,26
70858,Niš,150,,694,404,694,290,290,3,287,172,115
70858,Niš,151,,449,260,449,189,189,2,187,149,38
70858,Niš,152,,683,392,683,291,291,7,284,150,134
70858,Niš,153,,795,441,795,354,354,6,348,207,141
70858,Niš,154,,262,126,262,136,136,7,129,97,32
70866,Nova Varoš,1,,401,284,401,117,117,2,115,47,68
70866,Nova Varoš,2,,157,62,157,95,95,1,94,55,39
70866,Nova Varoš,3,,244,172,244,72,72,1,71,34,37
70866,Nova Varoš,4,,176,118,176,58,58,1,57,29,28
70866,Nova Varoš,5,,209,155,209,54,54,0,54,26,28
70866,Nova Varoš,6,,116,72,116,44,44,1,43,30,13
70866,Nova Varoš,7,,262,131,262,131,131,0,131,66,65
70866,Nova Varoš,8,,219,104,219,115,115,1,114,57,57
70866,Nova Varoš,9,,177,104,177,73,73,0,73,40,33
70866,Nova Varoš,10,,233,125,233,108,108,0,108,36,72
70866,Nova Varoš,11,,219,134,219,85,85,0,85,77,8
70866,Nova Varoš,12,,167,80,167,87,87,1,86,52,34
70866,Nova Varoš,13,,390,215,390,175,175,1,174,119,55
70866,Nova Varoš,14,,178,73,178,105,105,0,105,40,65
70866,Nova Varoš,15,,539,304,539,235,235,2,233,166,67
70866,Nova Varoš,16,,713,452,713,261,261,4,257,177,80
70866,Nova Varoš,17,,163,88,163,75,75,1,74,55,19
70866,Nova Varoš,18,,572,333,572,239,239,1,238,136,102
70866,Nova Varoš,19,,338,178,338,160,160,1,159,90,69
70866,Nova Varoš,20,,250,139,250,111,111,1,110,77,33
70866,Nova Varoš,21,,355,164,355,191,191,1,190,132,58
70866,Nova Varoš,22,,587,346,587,241,241,2,239,173,66
70866,Nova Varoš,23,,136,68,136,68,68,0,68,35,33
70866,Nova Varoš,24,,270,162,270,108,108,0,108,66,42
70866,Nova Varoš,25,,103,70,103,33,33,2,31,18,13
70866,Nova Varoš,26,,116,68,116,48,48,0,48,30,18
70866,Nova Varoš,27,,300,172,300,128,128,1,127,89,38
70866,Nova Varoš,28,,676,356,676,320,320,3,317,150,167
70866,Nova Varoš,29,,524,273,524,251,250,0,250,79,171
70866,Nova Varoš,30,,774,353,774,421,421,2,419,79,340
70866,Nova Varoš,31,,696,386,696,310,310,3,307,161,146
70866,Nova Varoš,32,,814,392,814,422,422,6,416,220,196
70866,Nova Varoš,33,,557,249,557,308,308,2,306,116,190
70866,Nova Varoš,34,,816,401,816,415,415,7,408,139,269
70866,Nova Varoš,35,,801,418,801,383,383,2,381,242,139
70866,Nova Varoš,36,,674,320,674,354,354,4,350,138,212
70866,Nova Varoš,37,,1059,626,1059,433,433,6,427,224,203
70866,Nova Varoš,38,,883,484,883,399,399,6,393,251,142
70874,Novi Pazar,1,,559,291,559,268,268,0,268,9,259
70874,Novi Pazar,2,,316,46,316,270,270,0,270,26,244
70874,Novi Pazar,3,,178,28,178,150,150,0,150,7,143
70874,Novi Pazar,4,,237,68,237,169,169,0,169,1,168
70874,Novi Pazar,5,,452,212,452,240,240,0,240,160,80
70874,Novi Pazar,6,,112,59,112,53,53,0,53,49,4
70874,Novi Pazar,7,,265,59,265,206,206,2,204,195,9
70874,Novi Pazar,8,,117,47,117,70,70,0,70,66,4
70874,Novi Pazar,9,,103,31,103,72,72,2,70,60,10
70874,Novi Pazar,10,,213,154,213,59,59,0,59,55,4
70874,Novi Pazar,11,,162,61,162,101,101,1,100,95,5
70874,Novi Pazar,12,,100,32,100,68,68,0,68,62,6
70874,Novi Pazar,13,,123,90,123,33,33,0,33,27,6
70874,Novi Pazar,14,,227,120,227,107,107,4,103,90,13
70874,Novi Pazar,15,,330,162,330,168,168,0,168,18,150
70874,Novi Pazar,16,,126,46,126,80,80,0,80,77,3
70874,Novi Pazar,17,,101,29,101,72,72,0,72,64,8
70874,Novi Pazar,18,,410,48,410,362,362,8,354,272,82
70874,Novi Pazar,19,,118,15,118,103,103,5,98,98,0
70874,Novi Pazar,20,,307,65,307,242,242,0,242,234,8
70874,Novi Pazar,21,,172,113,172,59,59,0,59,41,18
70874,Novi Pazar,22,,572,275,572,297,297,0,297,6,291
70874,Novi Pazar,23,,300,66,300,234,234,1,233,28,205
70874,Novi Pazar,24,,393,104,391,289,289,9,280,5,275
70874,Novi Pazar,25,,878,535,878,343,343,0,343,41,302
70874,Novi Pazar,26,,165,26,165,139,139,0,139,3,136
70874,Novi Pazar,27,,339,40,339,299,299,1,298,6,292
70874,Novi Pazar,28,,1768,572,1768,1196,1196,1,1195,16,1179
70874,Novi Pazar,29,,190,127,190,63,63,0,63,0,63
70874,Novi Pazar,30,,1086,466,1086,620,620,2,618,21,597
70874,Novi Pazar,31,,537,201,537,336,336,3,333,12,321
70874,Novi Pazar,32,,279,207,279,72,72,0,72,61,11
70874,Novi Pazar,33,,115,64,115,51,51,2,49,34,15
70874,Novi Pazar,34,,642,335,642,307,307,1,306,199,107
70874,Novi Pazar,35,,466,200,466,266,266,1,265,231,34
70874,Novi Pazar,36,,253,23,253,230,230,0,230,217,13
70874,Novi Pazar,37,,945,387,945,558,558,3,555,4,551
70874,Novi Pazar,38,,285,107,285,178,178,0,178,15,163
70874,Novi Pazar,39,,237,79,237,158,158,0,158,34,124
70874,Novi Pazar,40,,1564,914,1564,650,650,3,647,5,642
70874,Novi Pazar,41,,1369,565,1369,804,804,1,803,99,704
70874,Novi Pazar,42,,200,135,200,65,65,0,65,56,9
70874,Novi Pazar,43,,169,76,169,93,93,0,93,87,6
70874,Novi Pazar,44,,305,180,305,125,125,0,125,15,110
70874,Novi Pazar,45,,108,52,108,56,56,0,56,50,6
70874,Novi Pazar,46,,782,392,782,390,390,3,387,37,350
70874,Novi Pazar,47,,526,292,526,234,234,2,232,48,184
70874,Novi Pazar,48,,132,97,132,35,35,0,35,22,13
70874,Novi Pazar,49,,205,142,205,63,63,2,61,54,7
70874,Novi Pazar,50,,240,153,240,87,87,0,87,2,85
70874,Novi Pazar,51,,280,112,280,168,168,0,168,11,157
70874,Novi Pazar,52,,356,98,356,258,258,0,258,2,256
70874,Novi Pazar,53,,740,395,740,345,345,1,344,140,204
70874,Novi Pazar,54,,155,74,155,81,81,1,80,0,80
70874,Novi Pazar,55,,184,69,184,115,115,3,112,104,8
70874,Novi Pazar,56,,326,232,326,94,94,0,94,47,47
70874,Novi Pazar,57,,190,127,190,63,63,0,63,55,8
70874,Novi Pazar,58,,155,83,155,72,72,0,72,68,4
70874,Novi Pazar,59,,286,170,286,116,116,0,116,102,14
70874,Novi Pazar,60,,207,65,207,142,142,0,142,136,6
70874,Novi Pazar,61,,184,57,184,127,127,0,127,124,3
70874,Novi Pazar,62,,173,59,173,114,114,1,113,111,2
70874,Novi Pazar,63,,1678,844,1678,834,834,4,830,97,733
70874,Novi Pazar,64,,1808,919,1808,889,889,3,886,20,866
70874,Novi Pazar,65,,2137,967,2141,1170,1170,5,1165,89,1076
70874,Novi Pazar,66,,1568,768,1568,800,800,7,793,1,792
70874,Novi Pazar,67,,1539,837,1539,702,702,7,695,68,627
70874,Novi Pazar,68,,1349,647,1349,702,702,6,696,361,335
70874,Novi Pazar,69,,930,499,930,431,431,1,430,393,37
70874,Novi Pazar,70,,1023,523,1023,500,500,5,495,452,43
70874,Novi Pazar,71,,1497,738,1497,759,759,5,754,132,622
70874,Novi Pazar,72,,1651,828,1651,823,823,5,818,98,720
70874,Novi Pazar,73,,1686,811,1686,875,875,7,868,273,595
70874,Novi Pazar,74,,1524,666,1525,858,857,8,849,210,639
70874,Novi Pazar,75,,2094,1045,2094,1049,1047,5,1042,36,1006
70874,Novi Pazar,76,,1889,1051,1891,838,838,2,836,38,798
70874,Novi Pazar,77,,2298,1114,2298,1184,1183,3,1180,125,1055
70874,Novi Pazar,78,,2416,1235,2416,1181,1181,9,1172,163,1009
70874,Novi Pazar,79,,1441,732,1441,709,709,8,701,136,565
70874,Novi Pazar,80,,1178,597,1178,581,581,3,578,3,575
70874,Novi Pazar,81,,1618,750,1618,868,868,3,865,35,830
70874,Novi Pazar,82,,1996,1174,1996,822,822,4,818,7,811
70874,Novi Pazar,83,,2024,1012,2024,1012,1012,13,999,27,972
70874,Novi Pazar,84,,1291,664,1291,627,627,3,624,6,618
70874,Novi Pazar,85,,1514,709,1514,805,805,2,803,15,788
70874,Novi Pazar,86,,1695,779,1695,916,916,3,913,18,895
70874,Novi Pazar,87,,1519,868,1519,651,651,5,646,7,639
70874,Novi Pazar,88,,1243,591,1243,652,652,2,650,2,648
70874,Novi Pazar,89,,451,171,451,280,280,3,277,4,273
70882,Osečina,1,,1169,574,1169,595,595,9,586,262,324
70882,Osečina,2,,1187,541,1187,646,646,18,628,229,399
70882,Osečina,3,,783,430,783,353,353,3,350,186,164
70882,Osečina,4,,496,274,496,222,222,5,217,87,130
70882,Osečina,5,,455,210,455,245,245,12,233,112,121
70882,Osečina,6,,250,114,250,136,136,4,132,59,73
70882,Osečina,7,,211,93,211,118,118,5,113,58,55
70882,Osečina,8,,523,265,523,258,258,5,253,107,146
70882,Osečina,9,,985,625,985,360,360,2,358,174,184
70882,Osečina,10,,465,262,465,203,203,4,199,142,57
70882,Osečina,11,,229,99,229,130,130,4,126,59,67
70882,Osečina,12,,788,488,788,300,300,4,296,198,98
70882,Osečina,13,,113,76,113,37,37,0,37,22,15
70882,Osečina,14,,503,335,503,168,168,4,164,69,95
70882,Osečina,15,,472,295,472,177,177,1,176,103,73
70882,Osečina,16,,1065,687,1065,378,377,8,369,219,150
70882,Osečina,17,,513,322,513,191,191,2,189,120,69
70882,Osečina,18,,543,300,543,243,243,5,238,153,85
70882,Osečina,19,,499,266,499,233,233,3,230,158,72
70882,Osečina,20,,315,167,315,148,148,1,147,114,33
70882,Osečina,21,,398,118,398,280,280,13,267,112,155
70904,Paraćin,1,,846,412,846,434,434,4,430,206,224
70904,Paraćin,2,,854,417,856,437,437,8,429,194,235
70904,Paraćin,3,,755,311,756,444,444,6,438,163,275
70904,Paraćin,4,,824,406,827,418,418,4,414,188,226
70904,Paraćin,5,,838,391,839,447,447,12,435,216,219
70904,Paraćin,6,,936,418,936,518,518,11,507,226,281
70904,Paraćin,7,,1219,571,1221,648,648,12,636,302,334
70904,Paraćin,8,,1123,473,1122,650,650,14,636,322,314
70904,Paraćin,9,,982,434,981,548,547,14,533,216,317
70904,Paraćin,10,,1014,489,1015,525,525,7,518,235,283
70904,Paraćin,11,,803,363,804,440,440,10,430,178,252
70904,Paraćin,12,,668,291,669,377,377,8,369,149,220
70904,Paraćin,13,,1021,469,1021,552,552,14,538,277,261
70904,Paraćin,14,,1232,526,1232,706,706,15,691,329,362
70904,Paraćin,15,,1272,639,1273,633,633,12,621,267,354
70904,Paraćin,16,,1724,780,1724,944,944,15,929,458,471
70904,Paraćin,17,,1291,656,1291,635,635,6,629,411,218
70904,Paraćin,18,,1115,566,1119,549,549,9,540,334,206
70904,Paraćin,19,,864,438,867,426,426,9,417,253,164
70904,Paraćin,20,,912,527,914,385,385,7,378,230,148
70904,Paraćin,21,,987,471,992,516,516,11,505,306,199
70904,Paraćin,22,,932,504,933,428,428,8,420,244,176
70904,Paraćin,23,,839,426,839,413,413,2,411,236,175
70904,Paraćin,24,,1281,727,1284,554,554,4,550,265,285
70904,Paraćin,25,,864,545,864,319,319,8,311,167,144
70904,Paraćin,26,,901,427,901,474,474,7,467,261,206
70904,Paraćin,27,,231,111,231,120,120,5,115,57,58
70904,Paraćin,28,,700,379,700,321,321,7,314,235,79
70904,Paraćin,29,,738,427,738,311,311,2,309,114,195
70904,Paraćin,30,,417,195,417,222,222,1,221,148,73
70904,Paraćin,31,,1745,1025,1745,720,720,6,714,441,273
70904,Paraćin,32,,934,520,934,414,414,5,409,174,235
70904,Paraćin,33,,1729,1001,1729,728,728,11,717,418,299
70904,Paraćin,34,,599,324,599,275,275,3,272,180,92
70904,Paraćin,35,,725,405,725,320,320,3,317,210,107
70904,Paraćin,36,,480,250,480,230,230,4,226,90,136
70904,Paraćin,37,,406,174,406,232,232,2,230,133,97
70904,Paraćin,38,,620,302,619,318,318,2,316,237,79
70904,Paraćin,39,,348,217,348,131,131,1,130,72,58
70904,Paraćin,40,,731,429,731,302,302,6,296,205,91
70904,Paraćin,41,,1206,682,1206,524,524,3,521,291,230
70904,Paraćin,42,,908,542,908,366,366,4,362,201,161
70904,Paraćin,43,,1200,750,1200,450,450,6,444,285,159
70904,Paraćin,44,,483,214,483,269,269,3,266,128,138
70904,Paraćin,45,,1053,644,1054,409,409,4,405,232,173
70904,Paraćin,46,,841,413,841,428,428,7,421,272,149
70904,Paraćin,47,,187,53,188,134,133,2,131,74,57
70904,Paraćin,48,,1298,816,1298,482,482,5,477,316,161
70904,Paraćin,49,,1525,843,1524,682,682,8,674,380,294
70904,Paraćin,50,,1542,978,1542,564,564,7,557,385,172
70904,Paraćin,51,,846,425,848,421,421,3,418,298,120
70904,Paraćin,52,,1078,558,1078,520,520,10,510,228,282
70904,Paraćin,53,,683,373,683,310,310,0,310,165,145
70904,Paraćin,54,,581,301,582,280,280,2,278,114,164
70904,Paraćin,55,,425,238,425,187,187,5,182,58,124
70912,Petrovac,1,,761,324,761,437,437,11,426,222,204
70912,Petrovac,2,,515,359,515,156,156,2,154,103,51
70912,Petrovac,3,,905,592,905,313,313,10,303,188,115
70912,Petrovac,4,,595,420,595,175,175,1,174,122,52
70912,Petrovac,5,,655,469,655,186,186,2,184,106,78
70912,Petrovac,6,,546,399,546,147,147,3,144,53,91
70912,Petrovac,7,,711,465,711,246,246,1,245,142,103
70912,Petrovac,8,,648,424,648,224,224,2,222,104,118
70912,Petrovac,9,,721,451,721,270,270,4,266,182,84
70912,Petrovac,10,,553,353,553,200,200,2,198,78,120
70912,Petrovac,11,,493,314,493,179,179,2,177,80,97
70912,Petrovac,12,,525,335,525,190,190,4,186,56,130
70912,Petrovac,13,,217,136,217,81,81,2,79,40,39
70912,Petrovac,14,,694,399,694,295,295,2,293,129,164
70912,Petrovac,15,,672,411,672,261,261,5,256,112,144
70912,Petrovac,16,,925,620,925,305,305,4,301,159,142
70912,Petrovac,17,,670,386,670,284,284,2,282,126,156
70912,Petrovac,18,,982,576,982,406,406,6,400,225,175
70912,Petrovac,19,,587,344,587,243,243,5,238,121,117
70912,Petrovac,20,,776,432,776,344,344,5,339,196,143
70912,Petrovac,21,,591,381,591,210,210,3,207,105,102
70912,Petrovac,22,,455,263,455,192,192,4,188,89,99
70912,Petrovac,23,,491,335,491,156,156,7,149,75,74
70912,Petrovac,24,,670,357,670,313,313,4,309,141,168
70912,Petrovac,25,,819,510,819,309,309,11,298,169,129
70912,Petrovac,26,,625,432,625,193,193,4,189,71,118
70912,Petrovac,27,,495,349,495,146,146,4,142,72,70
70912,Petrovac,28,,924,542,924,382,382,11,371,230,141
70912,Petrovac,29,,406,249,406,157,157,3,154,91,63
70912,Petrovac,30,,432,238,432,194,194,2,192,99,93
70912,Petrovac,31,,881,398,881,483,483,10,473,234,239
70912,Petrovac,32,,674,309,674,365,365,7,358,146,212
70912,Petrovac,33,,799,388,799,411,411,6,405,176,229
70912,Petrovac,34,,815,421,815,394,394,11,383,164,219
70912,Petrovac,35,,937,467,937,470,470,5,465,201,264
70912,Petrovac,36,,1080,636,1080,444,444,3,441,204,237
70912,Petrovac,37,,1078,505,1078,573,573,4,569,248,321
70912,Petrovac,38,,709,507,709,202,202,3,199,123,76
70912,Petrovac,39,,759,500,759,259,259,4,255,131,124
70912,Petrovac,40,,582,469,582,113,113,2,111,66,45
70912,Petrovac,41,,939,572,938,367,367,8,359,188,171
70912,Petrovac,42,,547,359,547,188,188,0,188,104,84
70912,Petrovac,43,,569,408,569,161,161,5,156,93,63
70912,Petrovac,44,,695,441,695,254,254,6,248,130,118
70912,Petrovac,45,,1012,620,1012,392,392,7,385,201,184
70912,Petrovac,46,,790,553,790,237,237,3,234,173,61
70912,Petrovac,47,,653,396,653,257,257,5,252,170,82
70912,Petrovac,48,,615,378,615,237,237,6,231,144,87
70912,Petrovac,49,,798,464,798,334,334,1,333,129,204
70912,Petrovac,50,,864,497,864,367,367,2,365,136,229
70939,Pirot,1,,991,459,991,532,532,5,527,238,289
70939,Pirot,2,,1081,640,1081,441,441,4,437,226,211
70939,Pirot,3,,835,531,835,304,304,3,301,201,100
70939,Pirot,4,,969,660,969,309,309,3,306,180,126
70939,Pirot,5,,1024,528,1024,496,496,6,490,194,296
70939,Pirot,6,,908,401,908,507,507,7,500,214,286
70939,Pirot,7,,1192,605,1192,587,587,5,582,212,370
70939,Pirot,8,,859,436,859,423,423,5,418,119,299
70939,Pirot,9,,928,461,928,467,467,3,464,190,274
70939,Pirot,10,,969,500,970,469,469,1,468,205,263
70939,Pirot,11,,851,398,851,453,453,8,445,178,267
70939,Pirot,12,,1091,534,1091,557,557,6,551,194,357
70939,Pirot,13,,801,383,801,418,418,2,416,193,223
70939,Pirot,14,,1031,480,1031,551,550,6,544,204,340
70939,Pirot,15,,959,471,959,488,488,8,480,139,341
70939,Pirot,16,,908,443,908,465,465,5,460,222,238
70939,Pirot,17,,1127,491,1127,636,636,4,632,262,370
70939,Pirot,18,,879,390,879,489,489,4,485,170,315
70939,Pirot,19,,787,352,788,435,435,5,430,206,224
70939,Pirot,20,,785,368,785,417,417,8,409,173,236
70939,Pirot,21,,1277,665,1277,612,610,6,604,393,211
70939,Pirot,22,,994,460,994,534,534,12,522,241,281
70939,Pirot,23,,977,571,977,406,406,8,398,250,148
70939,Pirot,24,,1193,711,1193,482,482,4,478,342,136
70939,Pirot,25,,1131,497,1131,634,634,7,627,312,315
70939,Pirot,26,,914,416,914,498,498,6,492,247,245
70939,Pirot,27,,962,438,962,524,524,6,518,165,353
70939,Pirot,28,,990,476,990,514,514,7,507,159,348
70939,Pirot,29,,643,268,643,375,375,4,371,157,214
70939,Pirot,30,,779,382,779,397,397,6,391,160,231
70939,Pirot,31,,955,415,955,540,540,2,538,207,331
70939,Pirot,32,,905,448,905,457,457,3,454,310,144
70939,Pirot,33,,1045,476,1045,569,569,9,560,354,206
70939,Pirot,34,,1111,596,1111,515,515,6,509,290,219
70939,Pirot,35,,1197,597,1197,600,600,4,596,346,250
70939,Pirot,36,,1145,598,1145,547,547,9,538,377,161
70939,Pirot,37,,1601,945,1601,656,656,8,648,370,278
70939,Pirot,38,,565,330,565,235,235,2,233,157,76
70939,Pirot,39,,319,192,319,127,127,1,126,72,54
70939,Pirot,40,,147,95,147,52,52,1,51,48,3
70939,Pirot,41,,523,276,523,247,247,5,242,180,62
70939,Pirot,42,,262,147,262,115,115,2,113,59,54
70939,Pirot,43,,426,246,426,180,180,1,179,118,61
70939,Pirot,44,,231,137,231,94,94,2,92,56,36
70939,Pirot,45,,324,194,324,130,130,2,128,108,20
70939,Pirot,46,,143,62,143,81,81,1,80,70,10
70939,Pirot,47,,148,70,149,78,78,0,78,65,13
70939,Pirot,48,,408,169,408,239,239,4,235,171,64
70939,Pirot,49,,301,149,301,152,152,5,147,105,42
70939,Pirot,50,,210,99,210,111,111,3,108,67,41
70939,Pirot,51,,530,338,530,192,192,6,186,124,62
70939,Pirot,52,,204,94,204,110,110,3,107,71,36
70939,Pirot,53,,322,187,322,135,135,1,134,104,30
70939,Pirot,54,,236,106,236,130,130,4,126,84,42
70939,Pirot,55,,1192,597,1192,595,595,12,583,320,263
70939,Pirot,56,,285,142,285,143,143,4,139,72,67
70939,Pirot,57,,329,143,329,186,186,3,183,107,76
70939,Pirot,58,,116,50,116,66,66,1,65,33,32
70939,Pirot,59,,137,39,137,98,98,2,96,47,49
70939,Pirot,60,,1067,583,1067,484,484,6,478,278,200
70939,Pirot,61,,614,344,614,270,270,8,262,186,76
70939,Pirot,62,,638,328,638,310,310,5,305,160,145
70939,Pirot,63,,541,317,541,224,224,1,223,160,63
70939,Pirot,64,,143,68,143,75,75,1,74,57,17
70939,Pirot,65,,130,38,130,92,92,1,91,73,18
70939,Pirot,66,,164,86,164,78,78,0,78,72,6
70939,Pirot,67,,142,85,142,57,57,0,57,41,16
70939,Pirot,68,,100,65,100,35,35,0,35,30,5
70939,Pirot,69,,130,93,130,37,37,2,35,24,11
70939,Pirot,70,,164,36,164,128,128,0,128,107,21
70939,Pirot,71,,114,32,114,82,82,1,81,65,16
70939,Pirot,72,,323,105,323,218,218,5,213,179,34
70939,Pirot,73,,789,482,789,307,307,7,300,174,126
70939,Pirot,74,,186,114,186,72,72,1,71,59,12
70939,Pirot,75,,202,114,202,88,88,1,87,68,19
70939,Pirot,76,,171,115,171,56,56,5,51,39,12
70939,Pirot,77,,255,101,255,154,154,6,148,122,26
70939,Pirot,78,,251,15,251,236,236,1,235,221,14
70939,Pirot,79,,271,94,272,177,177,0,177,130,47
70939,Pirot,80,,174,82,174,92,92,0,92,60,32
70939,Pirot,81,,125,49,125,76,76,0,76,60,16
70939,Pirot,82,,100,49,100,51,51,0,51,33,18
70939,Pirot,83,,455,249,455,206,206,4,202,146,56
70939,Pirot,84,,305,146,305,159,159,4,155,94,61
70939,Pirot,85,,115,38,115,77,77,1,76,63,13
70947,Požarevac,1,,958,628,958,330,330,9,321,153,168
70947,Požarevac,2,,649,441,649,208,208,2,206,128,78
70947,Požarevac,3,,537,369,537,168,168,0,168,108,60
70947,Požarevac,4,,822,365,822,457,457,9,448,207,241
70947,Požarevac,5,,592,370,592,222,222,5,217,144,73
70947,Požarevac,6,,879,533,879,346,345,5,340,191,149
70947,Požarevac,7,,765,443,765,322,322,2,320,200,120
70947,Požarevac,8,,838,525,838,313,313,3,310,170,140
70947,Požarevac,9,,982,454,983,528,528,7,521,220,301
70947,Požarevac,10,,1060,558,1061,502,502,3,499,274,225
70947,Požarevac,11,,656,393,393,263,263,8,255,121,134
70947,Požarevac,12,,866,568,867,298,298,7,291,167,124
70947,Požarevac,13,,782,373,782,409,409,6,403,197,206
70947,Požarevac,14,,737,493,737,244,244,5,239,121,118
70947,Požarevac,15,,755,494,755,261,260,3,257,127,130
70947,Požarevac,16,,1010,544,1010,466,466,10,456,303,153
70947,Požarevac,17,,656,377,656,279,279,3,276,142,134
70947,Požarevac,18,,1337,642,1337,695,695,8,687,359,328
70947,Požarevac,19,,1413,633,1413,780,779,14,765,298,467
70947,Požarevac,20,,1202,473,1202,729,726,12,714,307,407
70947,Požarevac,21,,932,473,932,459,459,8,451,209,242
70947,Požarevac,22,,1075,510,1076,565,565,11,554,226,328
70947,Požarevac,23,,1091,633,1091,458,458,6,452,253,199
70947,Požarevac,24,,1031,580,1031,451,451,3,448,238,210
70947,Požarevac,25,,497,270,497,227,227,1,226,134,92
70947,Požarevac,26,,306,170,308,136,136,1,135,83,52
70947,Požarevac,27,,557,261,557,296,296,2,294,138,156
70947,Požarevac,28,,1142,718,1142,424,424,4,420,218,202
70947,Požarevac,29,,987,413,988,574,574,17,557,187,370
70947,Požarevac,30,,1141,420,1141,721,721,14,707,290,417
70947,Požarevac,31,,1117,525,1117,592,592,9,583,233,350
70947,Požarevac,32,,975,492,975,483,483,9,474,219,255
70947,Požarevac,33,,933,398,936,535,535,7,528,212,316
70947,Požarevac,34,,908,386,913,522,522,9,513,187,326
70947,Požarevac,35,,895,467,896,428,428,5,423,228,195
70947,Požarevac,36,,1010,481,1010,529,529,12,517,271,246
70947,Požarevac,37,,1167,559,1167,608,608,9,599,273,326
70947,Požarevac,38,,928,434,928,494,494,13,481,248,233
70947,Požarevac,39,,1211,634,1212,577,577,6,571,306,265
70947,Požarevac,40,,1200,627,1201,573,572,4,568,334,234
70947,Požarevac,41,,927,438,927,489,489,11,478,250,228
70947,Požarevac,42,,1002,405,1003,597,597,7,590,252,338
70947,Požarevac,43,,1041,397,1042,644,644,13,631,219,412
70947,Požarevac,44,,761,291,762,470,470,6,464,187,277
70947,Požarevac,45,,1045,469,1047,576,576,11,565,204,361
70947,Požarevac,46,,1230,641,1234,589,589,13,576,289,287
70947,Požarevac,47,,1065,488,1066,577,576,9,567,231,336
70947,Požarevac,48,,1118,507,1121,611,611,7,604,368,236
70947,Požarevac,49,,1734,846,1737,888,888,11,877,557,320
70947,Požarevac,50,,1606,747,1609,859,859,10,849,349,500
70947,Požarevac,51,,287,117,287,170,170,5,165,91,74
70947,Požarevac,52,,911,439,918,472,472,6,466,231,235
70947,Požarevac,53,,1087,478,1087,609,609,8,601,262,339
70947,Požarevac,54,,1775,882,1741,893,893,18,875,344,531
70947,Požarevac,55,,1312,742,1313,570,570,7,563,267,296
70947,Požarevac,56,,1233,739,1233,494,493,9,484,311,173
70947,Požarevac,57,,1284,590,1284,694,694,12,682,331,351
70947,Požarevac,58,,1634,905,1634,729,728,14,714,382,332
70947,Požarevac,59,,1246,559,1247,687,687,14,673,221,452
70947,Požarevac,60,,1361,657,1361,704,704,9,695,272,423
70947,Požarevac,61,,1271,664,1271,607,607,7,600,324,276
70947,Požarevac,62,,800,532,800,268,268,1,267,129,138
70947,Požarevac,63,,769,514,769,255,255,6,249,98,151
70947,Požarevac,64,,729,433,729,296,296,1,295,141,154
70947,Požarevac,65,,606,439,606,167,167,1,166,78,88
70947,Požarevac,66,,739,326,740,413,413,5,408,183,225
70947,Požarevac,67,,960,687,960,273,273,3,270,122,148
70947,Požarevac,68,,1202,813,1202,389,389,6,383,237,146
70955,Požega,1,,822,350,824,472,472,12,460,207,253
70955,Požega,2,,735,327,735,408,408,4,404,123,281
70955,Požega,3,,778,337,778,441,441,6,435,184,251
70955,Požega,4,,818,393,820,425,425,13,412,150,262
70955,Požega,5,,708,398,708,310,310,2,308,168,140
70955,Požega,6,,1124,540,1124,584,584,16,568,263,305
70955,Požega,7,,701,294,701,407,407,6,401,162,239
70955,Požega,8,,1625,814,1625,811,811,9,802,351,451
70955,Požega,9,,1793,898,1793,895,895,8,887,344,543
70955,Požega,10,,1254,645,1254,609,609,8,601,281,320
70955,Požega,11,,691,321,693,370,370,5,365,141,224
70955,Požega,12,,533,309,533,224,224,1,223,108,115
70955,Požega,13,,259,137,259,122,122,1,121,74,47
70955,Požega,14,,764,386,764,378,378,5,373,167,206
70955,Požega,15,,379,151,379,228,228,9,219,102,117
70955,Požega,16,,369,209,369,160,160,2,158,86,72
70955,Požega,17,,700,404,691,296,296,5,291,149,142
70955,Požega,18,,265,151,265,114,114,0,114,54,60
70955,Požega,19,,403,199,403,204,204,0,204,75,129
70955,Požega,20,,244,137,244,107,107,5,102,47,55
70955,Požega,21,,938,563,939,375,375,7,368,200,168
70955,Požega,22,,238,116,238,122,122,3,119,54,65
70955,Požega,23,,420,283,420,137,137,4,133,67,66
70955,Požega,24,,267,120,267,147,147,3,144,84,60
70955,Požega,25,,270,148,270,122,122,0,122,46,76
70955,Požega,26,,395,266,395,129,129,4,125,49,76
70955,Požega,27,,447,215,447,232,232,3,229,124,105
70955,Požega,28,,127,67,127,60,60,1,59,36,23
70955,Požega,29,,276,133,276,143,143,1,142,68,74
70955,Požega,30,,443,259,443,184,184,2,182,110,72
70955,Požega,31,,231,156,231,75,75,4,71,35,36
70955,Požega,32,,220,113,220,107,107,0,107,70,37
70955,Požega,33,,120,64,120,56,56,0,56,33,23
70955,Požega,34,,239,129,239,110,110,1,109,34,75
70955,Požega,35,,573,320,573,253,253,3,250,99,151
70955,Požega,36,,168,102,168,66,66,1,65,31,34
70955,Požega,37,,310,177,310,133,133,5,128,73,55
70955,Požega,38,,299,182,299,117,117,1,116,72,44
70955,Požega,39,,609,369,609,240,240,5,235,101,134
70955,Požega,40,,349,209,349,140,140,2,138,68,70
70955,Požega,41,,275,120,275,155,155,1,154,97,57
70955,Požega,42,,355,194,355,161,161,2,159,74,85
70955,Požega,43,,795,472,795,323,323,4,319,139,180
70955,Požega,44,,229,140,229,89,89,1,88,43,45
70955,Požega,45,,360,227,360,133,133,2,131,72,59
70955,Požega,46,,358,219,358,139,139,2,137,63,74
70955,Požega,47,,165,90,165,75,75,1,74,25,49
70955,Požega,48,,369,269,369,100,100,0,100,44,56
70955,Požega,49,,208,90,208,118,118,1,117,65,52
70955,Požega,50,,379,184,379,195,195,0,195,97,98
70955,Požega,51,,131,60,131,71,71,5,66,29,37
70955,Požega,52,,408,210,408,198,198,4,194,97,97
70955,Požega,53,,283,148,283,135,135,0,135,61,74
70963,Preševo,1,,875,846,875,29,29,1,28,19,9
70963,Preševo,2,,971,954,971,17,17,0,17,7,10
70963,Preševo,3,,1225,1218,1225,7,7,1,6,4,2
70963,Preševo,4,,1198,1162,1198,36,36,0,36,13,23
70963,Preševo,5,,918,914,918,4,4,0,4,0,4
70963,Preševo,6,,1197,1137,1197,60,60,3,57,27,30
70963,Preševo,7,,959,953,959,6,6,0,6,0,6
70963,Preševo,8,,1109,1094,1109,15,15,0,15,6,9
70963,Preševo,9,,1287,1267,1287,20,20,0,20,7,13
70963,Preševo,10,,458,298,458,160,160,0,160,139,21
70963,Preševo,11,,575,280,575,295,295,17,278,198,80
70963,Preševo,12,,606,602,606,4,4,0,4,0,4
70963,Preševo,13,,1064,982,1064,82,82,0,82,45,37
70963,Preševo,14,,864,857,864,7,7,0,7,0,7
70963,Preševo,15,,916,890,916,26,26,2,24,15,9
70963,Preševo,16,,694,694,694,0,0,0,0,0,0
70963,Preševo,17,,219,219,219,0,0,0,0,0,0
70963,Preševo,18,,194,194,194,0,0,0,0,0,0
70963,Preševo,19,,356,145,356,211,211,10,201,119,82
70963,Preševo,20,,377,325,377,52,52,0,52,28,24
70963,Preševo,21,,338,169,338,169,169,7,162,118,44
70963,Preševo,22,,870,870,870,0,0,0,0,0,0
70963,Preševo,23,,790,713,790,77,77,0,77,63,14
70963,Preševo,24,,708,638,708,70,70,0,70,56,14
70963,Preševo,25,,101,29,101,72,72,0,72,68,4
70963,Preševo,26,,654,575,654,79,79,0,79,42,37
70963,Preševo,27,,156,50,156,106,106,4,102,97,5
70963,Preševo,28,,820,808,820,12,12,0,12,0,12
70963,Preševo,29,,692,684,692,8,8,0,8,0,8
70963,Preševo,30,,812,752,812,60,60,0,60,0,60
70963,Preševo,31,,809,803,809,6,6,0,6,0,6
70963,Preševo,32,,586,586,586,0,0,0,0,0,0
70963,Preševo,33,,821,821,821,0,0,0,0,0,0
70963,Preševo,34,,746,744,746,2,2,0,2,0,2
70963,Preševo,35,,1361,1361,1361,0,0,0,0,0,0
70963,Preševo,36,,678,678,678,0,0,0,0,0,0
70963,Preševo,37,,699,699,699,0,0,0,0,0,0
70963,Preševo,38,,509,509,509,0,0,0,0,0,0
70971,Priboj,1,,1261,732,1261,529,529,2,527,112,415
70971,Priboj,2,,1074,593,1074,481,481,1,480,129,351
70971,Priboj,3,,957,586,957,371,371,5,366,95,271
70971,Priboj,4,,851,461,851,390,390,4,386,157,229
70971,Priboj,5,,828,490,828,338,338,0,338,203,135
70971,Priboj,6,,923,610,923,313,313,1,312,92,220
70971,Priboj,7,,812,496,812,316,316,2,314,62,252
70971,Priboj,8,,890,610,890,280,280,3,277,42,235
70971,Priboj,9,,903,573,903,330,330,2,328,140,188
70971,Priboj,10,,1117,620,1117,497,496,4,492,220,272
70971,Priboj,11,,725,396,725,329,329,4,325,124,201
70971,Priboj,12,,950,535,950,415,415,3,412,144,268
70971,Priboj,13,,722,427,722,295,295,6,289,92,197
70971,Priboj,14,,743,418,743,325,325,2,323,131,192
70971,Priboj,15,,639,336,639,303,303,6,297,100,197
70971,Priboj,16,,904,518,904,386,386,5,381,165,216
70971,Priboj,17,,912,502,912,410,410,1,409,193,216
70971,Priboj,18,,725,479,725,246,246,1,245,146,99
70971,Priboj,19,,1035,580,1035,455,455,1,454,272,182
70971,Priboj,20,,979,674,979,305,305,4,301,212,89
70971,Priboj,21,,1018,647,1018,371,371,4,367,185,182
70971,Priboj,22,,463,325,463,138,138,0,138,92,46
70971,Priboj,23,,369,268,369,101,101,1,100,79,21
70971,Priboj,24,,229,172,229,57,57,0,57,30,27
70971,Priboj,25,,581,369,581,212,212,0,212,152,60
70971,Priboj,26,,105,61,105,44,44,0,44,35,9
70971,Priboj,27,,104,41,104,63,63,3,60,53,7
70971,Priboj,28,,181,108,181,73,73,0,73,56,17
70971,Priboj,29,,373,224,373,149,149,1,148,91,57
70971,Priboj,30,,423,294,423,129,129,2,127,80,47
70971,Priboj,31,,105,68,105,37,37,7,30,26,4
70971,Priboj,32,,113,63,113,50,50,0,50,30,20
70971,Priboj,33,,332,238,332,94,94,1,93,18,75
70971,Priboj,34,,103,21,103,82,82,0,82,63,19
70971,Priboj,35,,532,341,529,191,191,2,189,107,82
70971,Priboj,36,,183,98,183,85,85,1,84,67,17
70971,Priboj,37,,287,207,287,80,80,0,80,61,19
70971,Priboj,38,,157,100,157,57,57,0,57,38,19
70971,Priboj,39,,127,108,127,19,19,0,19,16,3
70971,Priboj,40,,199,159,199,40,40,0,40,30,10
70971,Priboj,41,,339,179,339,160,160,3,157,88,69
70971,Priboj,42,,292,226,292,66,66,0,66,25,41
70971,Priboj,43,,147,109,147,38,38,0,38,25,13
70971,Priboj,44,,174,135,174,39,39,0,39,18,21
70971,Priboj,45,,116,99,116,17,17,0,17,8,9
70971,Priboj,46,,169,140,169,29,29,0,29,22,7
70971,Priboj,47,,248,181,248,67,67,0,67,49,18
70971,Priboj,48,,309,210,309,99,99,0,99,2,97
70980,Prijepoqe,1,,202,104,202,98,98,0,98,73,25
70980,Prijepolje,2,,119,46,119,73,73,0,73,44,29
70980,Prijepolje,3,,115,66,115,49,49,0,49,3,46
70980,Prijepolje,4,,172,64,172,108,108,0,108,92,16
70980,Prijepolje,5,,122,79,122,43,43,0,43,1,42
70980,Prijepolje,6,,340,192,340,148,148,0,148,4,144
70980,Prijepolje,7,,190,138,190,52,52,0,52,43,9
70980,Prijepolje,8,,221,108,221,113,113,0,113,96,17
70980,Prijepolje,9,,186,132,186,54,54,0,54,42,12
70980,Prijepolje,10,,269,122,269,147,147,3,144,126,18
70980,Prijepolje,11,,134,56,134,78,78,1,77,3,74
70980,Prijepolje,12,,467,258,467,209,209,2,207,134,73
70980,Prijepolje,13,,117,67,117,50,50,0,50,30,20
70980,Prijepolje,14,,123,27,123,96,96,0,96,81,15
70980,Prijepolje,15,,282,142,282,140,140,0,140,64,76
70980,Prijepolje,16,,165,108,165,57,57,1,56,26,30
70980,Prijepolje,17,,117,57,117,60,60,0,60,51,9
70980,Prijepolje,18,,167,45,167,122,122,1,121,106,15
70980,Prijepolje,19,,121,36,121,85,85,0,85,84,1
70980,Prijepolje,20,,164,127,164,37,37,0,37,28,9
70980,Prijepolje,21,,151,106,151,45,45,1,44,36,8
70980,Prijepolje,22,,118,81,118,37,37,2,35,28,7
70980,Prijepolje,23,,136,89,136,47,47,0,47,39,8
70980,Prijepolje,24,,123,97,123,26,26,0,26,18,8
70980,Prijepolje,25,,235,122,235,113,113,3,110,79,31
70980,Prijepolje,26,,101,54,101,47,47,1,46,41,5
70980,Prijepolje,27,,206,123,206,83,83,0,83,65,18
70980,Prijepolje,28,,153,89,153,64,64,2,62,53,9
70980,Prijepolje,29,,476,235,472,241,241,2,239,209,30
70980,Prijepolje,30,,222,110,222,112,112,0,112,94,18
70980,Prijepolje,31,,276,152,276,124,124,0,124,70,54
70980,Prijepolje,32,,154,42,154,112,112,2,110,100,10
70980,Prijepolje,33,,236,93,236,143,143,0,143,78,65
70980,Prijepolje,34,,882,447,878,435,435,5,430,221,209
70980,Prijepolje,35,,237,144,237,93,93,0,93,77,16
70980,Prijepolje,36,,153,74,153,79,79,0,79,63,16
70980,Prijepolje,37,,229,170,229,59,59,1,58,17,41
70980,Prijepolje,38,,262,203,262,59,59,1,58,2,56
70980,Prijepolje,39,,140,89,140,51,51,0,51,1,50
70980,Prijepolje,40,,175,80,175,95,95,1,94,5,89
70980,Prijepolje,41,,258,174,258,84,84,0,84,60,24
70980,Prijepolje,42,,278,207,278,71,71,0,71,6,65
70980,Prijepolje,43,,144,89,144,55,55,0,55,32,23
70980,Prijepolje,44,,111,70,111,41,41,0,41,1,40
70980,Prijepolje,45,,256,210,256,46,46,0,46,4,42
70980,Prijepolje,46,,163,114,163,49,49,0,49,0,49
70980,Prijepolje,47,,108,65,108,43,43,0,43,29,14
70980,Prijepolje,48,,247,196,247,51,51,0,51,6,45
70980,Prijepolje,49,,113,23,113,90,90,0,90,11,79
70980,Prijepolje,50,,469,250,469,219,219,2,217,38,179
70980,Prijepolje,51,,1062,611,1065,451,451,2,449,105,344
70980,Prijepolje,52,,1140,748,1140,392,392,3,389,32,357
70980,Prijepolje,53,,178,109,178,69,69,1,68,9,59
70980,Prijepolje,54,,1029,598,1029,431,431,3,428,101,327
70980,Prijepolje,55,,178,79,178,99,99,0,99,2,97
70980,Prijepolje,56,,937,561,936,376,376,9,367,128,239
70980,Prijepolje,57,,433,240,433,193,193,2,191,87,104
70980,Prijepolje,58,,145,93,145,52,52,0,52,25,27
70980,Prijepolje,59,,962,531,962,431,431,1,430,192,238
70980,Prijepolje,60,,714,398,714,316,316,2,314,169,145
70980,Prijepolje,61,,1004,560,1004,444,444,1,443,213,230
70980,Prijepolje,62,,984,498,984,486,486,3,483,192,291
70980,Prijepolje,63,,1096,512,1096,584,584,7,577,377,200
70980,Prijepolje,64,,655,306,655,349,349,2,347,201,146
70980,Prijepolje,65,,670,278,670,392,392,4,388,303,85
70980,Prijepolje,66,,850,393,853,457,457,7,450,124,326
70980,Prijepolje,67,,914,481,914,433,433,7,426,63,363
70980,Prijepolje,68,,1296,598,1296,698,698,4,694,303,391
70980,Prijepolje,69,,1136,527,1136,609,609,5,604,213,391
70980,Prijepolje,70,,949,420,949,529,529,6,523,142,381
70980,Prijepolje,71,,490,234,491,256,256,2,254,85,169
70980,Prijepolje,72,,574,279,574,295,295,3,292,246,46
70980,Prijepolje,73,,757,339,757,418,418,3,415,131,284
70980,Prijepolje,74,,937,414,937,523,523,5,518,209,309
70980,Prijepolje,75,,782,366,782,416,416,0,416,143,273
70980,Prijepolje,76,,675,326,677,349,349,2,347,51,296
70980,Prijepolje,77,,1241,639,1241,602,602,6,596,329,267
70980,Prijepolje,78,,1350,692,1351,658,658,2,656,304,352
70998,Prokuplje,1,,383,184,382,199,199,3,196,88,108
70998,Prokuplje,2,,684,357,686,327,327,0,327,121,206
70998,Prokuplje,3,,688,425,688,263,263,5,258,133,125
70998,Prokuplje,4,,1007,496,1012,511,511,5,506,235,271
70998,Prokuplje,5,,1344,763,1346,581,581,6,575,323,252
70998,Prokuplje,6,,1038,508,1040,530,530,19,511,197,314
70998,Prokuplje,7,,1182,581,1184,601,601,7,594,251,343
70998,Prokuplje,8,,1198,599,1199,599,599,5,594,278,316
70998,Prokuplje,9,,561,279,561,282,282,5,277,143,134
70998,Prokuplje,10,,894,469,898,425,425,1,424,224,200
70998,Prokuplje,11,,1185,678,1187,507,507,0,507,305,202
70998,Prokuplje,12,,440,240,440,200,200,2,198,120,78
70998,Prokuplje,13,,751,355,752,396,396,12,384,171,213
70998,Prokuplje,14,,398,215,398,183,183,1,182,125,57
70998,Prokuplje,15,,734,347,736,387,387,10,377,170,207
70998,Prokuplje,16,,658,306,661,352,352,4,348,146,202
70998,Prokuplje,17,,519,254,520,265,265,3,262,101,161
70998,Prokuplje,18,,747,431,746,316,316,1,315,157,158
70998,Prokuplje,19,,943,577,943,366,366,8,358,194,164
70998,Prokuplje,20,,426,250,426,176,176,3,173,111,62
70998,Prokuplje,21,,211,102,211,109,109,1,108,69,39
70998,Prokuplje,22,,178,89,179,89,89,1,88,55,33
70998,Prokuplje,23,,1093,559,1092,534,533,6,527,248,279
70998,Prokuplje,24,,1012,555,1012,457,457,1,456,246,210
70998,Prokuplje,25,,271,177,272,94,94,0,94,61,33
70998,Prokuplje,26,,451,248,451,203,203,2,201,108,93
70998,Prokuplje,27,,866,464,866,402,401,5,396,189,207
70998,Prokuplje,28,,2262,1262,2265,1000,1000,6,994,486,508
70998,Prokuplje,29,,1914,1046,1914,868,864,22,842,399,443
70998,Prokuplje,30,,622,423,622,199,199,0,199,79,120
70998,Prokuplje,31,,330,183,330,147,147,1,146,91,55
70998,Prokuplje,32,,675,329,675,346,346,6,340,277,63
70998,Prokuplje,33,,299,174,299,125,125,1,124,68,56
70998,Prokuplje,34,,143,71,143,72,72,0,72,66,6
70998,Prokuplje,35,,179,102,179,77,77,0,77,52,25
70998,Prokuplje,36,,103,79,103,24,24,0,24,17,7
70998,Prokuplje,37,,106,75,106,31,31,0,31,29,2
70998,Prokuplje,38,,650,388,650,262,262,2,260,199,61
70998,Prokuplje,39,,399,246,399,153,153,1,152,114,38
70998,Prokuplje,40,,207,118,207,89,89,5,84,62,22
70998,Prokuplje,41,,487,283,487,204,204,1,203,156,47
70998,Prokuplje,42,,156,61,156,95,95,0,95,81,14
70998,Prokuplje,43,,210,88,210,122,122,0,122,92,30
70998,Prokuplje,44,,468,217,468,251,251,6,245,154,91
70998,Prokuplje,45,,284,130,284,154,154,0,154,81,73
70998,Prokuplje,46,,278,119,278,159,159,1,158,63,95
70998,Prokuplje,47,,124,39,125,85,85,1,84,37,47
70998,Prokuplje,48,,256,94,256,162,162,1,161,91,70
70998,Prokuplje,49,,152,107,152,45,45,0,45,35,10
70998,Prokuplje,50,,123,88,123,35,35,1,34,24,10
70998,Prokuplje,51,,273,159,273,114,114,0,114,90,24
70998,Prokuplje,52,,148,84,148,64,64,0,64,53,11
70998,Prokuplje,53,,303,144,303,159,159,0,159,109,50
70998,Prokuplje,54,,499,247,499,252,252,3,249,148,101
70998,Prokuplje,55,,120,60,120,60,60,0,60,37,23
70998,Prokuplje,56,,176,73,176,103,103,0,103,55,48
70998,Prokuplje,57,,125,73,125,52,52,2,50,26,24
70998,Prokuplje,58,,130,58,130,72,72,0,72,26,46
70998,Prokuplje,59,,108,33,108,75,75,0,75,26,49
70998,Prokuplje,60,,329,161,329,168,168,3,165,102,63
70998,Prokuplje,61,,136,50,136,86,86,0,86,36,50
70998,Prokuplje,62,,113,29,113,84,84,4,80,66,14
70998,Prokuplje,63,,106,17,106,89,89,0,89,62,27
70998,Prokuplje,64,,215,96,215,119,119,2,117,73,44
70998,Prokuplje,65,,124,54,124,70,70,2,68,42,26
70998,Prokuplje,66,,462,293,462,169,169,0,169,123,46
70998,Prokuplje,67,,301,116,301,185,185,1,184,138,46
70998,Prokuplje,68,,399,201,398,198,198,2,196,110,86
70998,Prokuplje,69,,135,58,135,77,77,1,76,39,37
70998,Prokuplje,70,,108,40,108,68,68,0,68,26,42
70998,Prokuplje,71,,107,79,107,28,28,0,28,21,7
70998,Prokuplje,72,,101,57,101,44,44,6,38,27,11
70998,Prokuplje,73,,145,75,146,70,70,1,69,49,20
70998,Prokuplje,74,,135,75,135,60,60,1,59,36,23
70998,Prokuplje,75,,124,70,124,54,54,1,53,44,9
70998,Prokuplje,76,,183,138,183,45,45,0,45,38,7
70998,Prokuplje,77,,163,139,163,24,24,0,24,22,2
70998,Prokuplje,78,,764,415,767,349,349,5,344,238,106
70998,Prokuplje,79,,405,179,405,226,226,6,220,132,88
70998,Prokuplje,80,,248,114,248,134,134,4,130,112,18
70998,Prokuplje,81,,207,90,207,117,117,2,115,44,71
70998,Prokuplje,82,,177,85,178,92,92,1,91,72,19
70998,Prokuplje,83,,169,52,169,117,117,0,117,86,31
70998,Prokuplje,84,,218,90,218,128,128,0,128,67,61
70998,Prokuplje,85,,135,60,135,75,75,0,75,21,54
70998,Prokuplje,86,,313,173,313,140,140,1,139,95,44
70998,Prokuplje,87,,182,102,182,80,80,4,76,60,16
70998,Prokuplje,88,,183,73,183,110,110,0,110,72,38
70998,Prokuplje,89,,173,67,173,106,106,1,105,73,32
70998,Prokuplje,90,,208,117,208,91,91,0,91,60,31
70998,Prokuplje,91,,279,116,279,163,163,0,163,117,46
70998,Prokuplje,92,,213,101,216,112,112,1,111,58,53
70998,Prokuplje,93,,159,95,159,64,64,0,64,40,24
70998,Prokuplje,94,,168,63,168,105,105,0,105,54,51
71005,Ražanj,1,,1158,598,1158,560,560,10,550,334,216
71005,Ražanj,2,,1035,645,1035,390,390,4,386,233,153
71005,Ražanj,3,,819,516,819,303,303,2,301,154,147
71005,Ražanj,4,,889,610,889,279,279,4,275,180,95
71005,Ražanj,5,,403,242,403,161,161,2,159,123,36
71005,Ražanj,6,,325,158,325,167,167,3,164,116,48
71005,Ražanj,7,,157,76,157,81,81,0,81,49,32
71005,Ražanj,8,,159,68,159,91,91,3,88,69,19
71005,Ražanj,9,,350,170,351,180,180,1,179,137,42
71005,Ražanj,10,,363,188,363,175,175,4,171,126,45
71005,Ražanj,11,,439,200,439,239,239,2,237,124,113
71005,Ražanj,12,,306,181,306,125,125,0,125,72,53
71005,Ražanj,13,,301,200,301,101,101,7,94,53,41
71005,Ražanj,14,,414,251,414,163,163,3,160,105,55
71005,Ražanj,15,,315,169,315,146,146,4,142,111,31
71005,Ražanj,16,,229,132,229,97,97,0,97,38,59
71005,Ražanj,17,,188,79,188,109,109,1,108,85,23
71005,Ražanj,18,,367,213,368,154,154,4,150,114,36
71005,Ražanj,19,,129,59,129,70,70,1,69,49,20
71005,Ražanj,20,,405,254,405,151,151,3,148,116,32
71005,Ražanj,21,,100,44,100,56,56,1,55,40,15
71005,Ražanj,22,,209,113,209,96,96,3,93,47,46
71013,Rača,1,,316,169,316,147,147,3,144,62,82
71013,Rača,2,,470,252,471,218,218,5,213,97,116
71013,Rača,3,,264,153,265,111,111,0,111,28,83
71013,Rača,4,,392,223,392,169,169,3,166,50,116
71013,Rača,5,,305,161,305,144,144,1,143,56,87
71013,Rača,6,,279,121,280,158,158,1,157,66,91
71013,Rača,7,,333,172,333,161,161,0,161,102,59
71013,Rača,8,,413,236,413,177,177,4,173,62,111
71013,Rača,9,,360,254,360,106,106,1,105,54,51
71013,Rača,10,,354,193,354,161,161,3,158,55,103
71013,Rača,11,,323,200,323,123,123,4,119,41,78
71013,Rača,12,,215,128,215,87,87,1,86,26,60
71013,Rača,13,,258,143,258,115,115,4,111,38,73
71013,Rača,14,,309,154,309,155,155,3,152,52,100
71013,Rača,15,,482,313,482,169,169,0,169,92,77
71013,Rača,16,,558,349,558,209,209,0,209,86,123
71013,Rača,17,,336,160,336,176,176,4,172,78,94
71013,Rača,18,,456,236,456,220,220,4,216,104,112
71013,Rača,19,,322,154,321,168,168,10,158,83,75
71013,Rača,20,,359,164,359,195,195,6,189,81,108
71013,Rača,21,,439,216,441,223,223,7,216,89,127
71013,Rača,22,,237,106,237,131,131,1,130,58,72
71013,Rača,23,,411,171,412,240,240,3,237,123,114
71013,Rača,24,,502,226,501,276,276,6,270,109,161
71013,Rača,25,,354,250,354,104,104,2,102,37,65
71013,Rača,26,,310,206,310,104,104,2,102,39,63
71013,Rača,27,,271,185,271,86,86,3,83,29,54
71013,Rača,28,,226,118,226,108,108,4,104,42,62
71013,Rača,29,,293,154,293,139,139,2,137,56,81
71013,Rača,30,,415,240,415,175,175,2,173,74,99
71013,Rača,31,,345,183,345,162,162,2,160,72,88
71021,Raška,1,,960,532,960,428,428,9,419,232,187
71021,Raška,2,,1215,762,1215,453,453,3,450,273,177
71021,Raška,3,,822,398,822,424,424,6,418,200,218
71021,Raška,4,,1365,718,1365,647,647,8,639,300,339
71021,Raška,5,,924,523,924,401,401,5,396,232,164
71021,Raška,6,,1609,965,1609,644,644,9,635,438,197
71021,Raška,7,,1548,930,1550,618,618,9,609,386,223
71021,Raška,8,,232,149,232,83,83,0,83,80,3
71021,Raška,9,,458,324,458,134,134,1,133,102,31
71021,Raška,10,,231,133,231,98,98,5,93,64,29
71021,Raška,11,,407,211,407,196,196,4,192,113,79
71021,Raška,12,,797,413,797,384,384,8,376,269,107
71021,Raška,13,,438,249,438,189,189,4,185,128,57
71021,Raška,14,,186,139,186,47,47,2,45,29,16
71021,Raška,15,,517,287,517,230,230,7,223,163,60
71021,Raška,16,,231,138,231,93,93,1,92,75,17
71021,Raška,17,,111,64,111,47,47,1,46,35,11
71021,Raška,18,,166,91,166,75,75,2,73,58,15
71021,Raška,19,,124,70,124,54,54,1,53,43,10
71021,Raška,20,,1001,591,1001,410,410,11,399,282,117
71021,Raška,21,,156,45,156,111,111,0,111,104,7
71021,Raška,22,,111,59,111,52,52,0,52,38,14
71021,Raška,23,,232,75,236,157,157,3,154,149,5
71021,Raška,24,,269,214,269,55,55,1,54,49,5
71021,Raška,25,,151,93,151,58,58,0,58,52,6
71021,Raška,26,,446,242,446,204,204,9,195,119,76
71021,Raška,27,,271,146,271,125,125,5,120,94,26
71021,Raška,28,,280,198,280,82,82,0,82,63,19
71021,Raška,29,,488,305,488,183,183,1,182,121,61
71021,Raška,30,,183,126,183,57,57,0,57,43,14
71021,Raška,31,,419,250,419,169,169,2,167,123,44
71021,Raška,32,,190,103,190,87,87,3,84,58,26
71021,Raška,33,,155,72,155,83,83,3,80,56,24
71021,Raška,34,,105,64,105,41,41,3,38,22,16
71021,Raška,35,,197,97,197,100,100,0,100,93,7
71021,Raška,36,,286,222,286,64,64,1,63,60,3
71021,Raška,37,,140,96,140,44,44,1,43,39,4
71021,Raška,38,,360,232,360,128,128,1,127,89,38
71021,Raška,39,,249,146,249,103,103,0,103,76,27
71021,Raška,40,,1284,665,1284,619,619,12,607,326,281
71021,Raška,41,,783,416,783,367,367,6,361,164,197
71021,Raška,42,,157,99,157,58,58,0,58,38,20
71021,Raška,43,,177,86,177,91,91,5,86,34,52
71021,Raška,44,,274,189,274,85,85,0,85,62,23
71021,Raška,45,,435,310,435,125,125,1,124,90,34
71021,Raška,46,,625,408,625,217,217,5,212,165,47
71021,Raška,47,,231,123,231,108,108,6,102,58,44
71021,Raška,48,,295,143,295,152,152,7,145,93,52
71030,Rekovac,1,,393,116,393,277,277,7,270,106,164
71030,Rekovac,2,,405,130,405,275,275,6,269,109,160
71030,Rekovac,3,,418,232,418,186,186,1,185,88,97
71030,Rekovac,4,,201,105,201,96,96,2,94,52,42
71030,Rekovac,5,,213,85,213,128,128,4,124,64,60
71030,Rekovac,6,,232,104,232,128,128,1,127,65,62
71030,Rekovac,7,,532,289,532,243,243,5,238,96,142
71030,Rekovac,8,,455,220,455,235,235,1,234,81,153
71030,Rekovac,9,,596,311,596,285,285,10,275,145,130
71030,Rekovac,10,,381,231,381,150,150,2,148,42,106
71030,Rekovac,11,,384,245,384,139,139,10,129,47,82
71030,Rekovac,12,,132,53,132,79,79,0,79,18,61
71030,Rekovac,13,,285,101,285,184,184,4,180,76,104
71030,Rekovac,14,,216,89,216,127,127,7,120,58,62
71030,Rekovac,15,,309,105,309,204,204,2,202,71,131
71030,Rekovac,16,,156,56,156,100,100,4,96,51,45
71030,Rekovac,17,,455,212,455,243,243,3,240,106,134
71030,Rekovac,18,,114,49,114,65,65,0,65,19,46
71030,Rekovac,19,,228,136,228,92,92,0,92,40,52
71030,Rekovac,20,,198,88,198,110,110,1,109,55,54
71030,Rekovac,21,,422,221,422,201,200,1,199,85,114
71030,Rekovac,22,,447,219,447,228,228,4,224,66,158
71030,Rekovac,23,,298,156,298,142,142,5,137,89,48
71030,Rekovac,24,,193,108,192,85,85,5,80,37,43
71030,Rekovac,25,,105,62,105,43,43,0,43,32,11
71030,Rekovac,26,,574,275,574,299,299,7,292,132,160
71030,Rekovac,27,,552,243,552,309,309,2,307,122,185
71030,Rekovac,28,,483,234,483,249,249,8,241,110,131
71030,Rekovac,29,,305,173,305,132,132,1,131,54,77
71030,Rekovac,30,,403,241,403,162,162,3,159,78,81
71030,Rekovac,31,,220,109,220,111,111,3,108,51,57
71030,Rekovac,32,,143,82,143,61,61,1,60,43,17
71030,Rekovac,33,,520,210,520,310,310,2,308,101,207
71030,Rekovac,34,,342,176,342,166,166,1,165,77,88
71030,Rekovac,35,,230,61,230,169,169,4,165,55,110
71030,Rekovac,36,,165,76,165,89,89,1,88,48,40
71048,Jagodina,1,,724,410,724,314,314,6,308,155,153
71048,Jagodina,2,,458,260,458,198,198,3,195,124,71
71048,Jagodina,3,,428,221,428,207,207,1,206,117,89
71048,Jagodina,4,,304,175,304,129,129,1,128,90,38
71048,Jagodina,5,,371,218,371,153,153,2,151,85,66
71048,Jagodina,6,,203,108,203,95,95,0,95,74,21
71048,Jagodina,7,,1202,810,1202,392,392,3,389,237,152
71048,Jagodina,8,,924,610,924,314,314,2,312,158,154
71048,Jagodina,9,,842,501,842,341,341,4,337,189,148
71048,Jagodina,10,,688,420,690,268,268,2,266,109,157
71048,Jagodina,11,,666,379,666,287,287,0,287,133,154
71048,Jagodina,12,,432,304,432,128,128,4,124,93,31
71048,Jagodina,13,,673,361,673,312,312,4,308,169,139
71048,Jagodina,14,,515,322,515,193,193,3,190,119,71
71048,Jagodina,15,,444,220,444,224,224,6,218,95,123
71048,Jagodina,16,,396,166,396,230,230,2,228,101,127
71048,Jagodina,17,,1072,610,1066,462,462,10,452,277,175
71048,Jagodina,18,,1021,577,1021,444,444,6,438,266,172
71048,Jagodina,19,,228,103,228,125,125,1,124,73,51
71048,Jagodina,20,,611,417,613,194,194,4,190,122,68
71048,Jagodina,21,,353,196,353,157,157,7,150,109,41
71048,Jagodina,22,,435,249,435,186,186,6,180,134,46
71048,Jagodina,23,,1220,776,1220,444,444,0,444,305,139
71048,Jagodina,24,,790,469,790,321,321,2,319,215,104
71048,Jagodina,25,,934,514,935,420,420,9,411,240,171
71048,Jagodina,26,,614,402,614,212,212,0,212,134,78
71048,Jagodina,27,,202,85,202,117,117,1,116,92,24
71048,Jagodina,28,,524,217,524,307,307,12,295,139,156
71048,Jagodina,29,,547,289,547,258,258,3,255,148,107
71048,Jagodina,30,,505,258,505,247,247,2,245,137,108
71048,Jagodina,31,,715,425,715,290,289,6,283,174,109
71048,Jagodina,32,,565,354,565,211,211,3,208,102,106
71048,Jagodina,33,,494,297,494,197,197,4,193,105,88
71048,Jagodina,34,,748,397,749,351,351,4,347,147,200
71048,Jagodina,35,,583,338,583,245,244,7,237,151,86
71048,Jagodina,36,,111,33,111,78,78,0,78,35,43
71048,Jagodina,37,,768,452,768,316,316,3,313,194,119
71048,Jagodina,38,,436,248,436,188,188,12,176,85,91
71048,Jagodina,39,,604,333,605,271,271,5,266,170,96
71048,Jagodina,40,,391,248,392,143,143,5,138,87,51
71048,Jagodina,41,,507,309,507,198,198,4,194,84,110
71048,Jagodina,42,,246,139,246,107,107,1,106,56,50
71048,Jagodina,43,,155,98,155,57,57,0,57,39,18
71048,Jagodina,44,,145,80,145,65,65,2,63,47,16
71048,Jagodina,45,,414,199,414,215,215,1,214,124,90
71048,Jagodina,46,,350,222,350,128,128,2,126,82,44
71048,Jagodina,47,,218,134,218,84,84,1,83,55,28
71048,Jagodina,48,,896,763,896,133,133,3,130,63,67
71048,Jagodina,49,,425,329,425,96,96,2,94,45,49
71048,Jagodina,50,,253,143,253,110,110,1,109,57,52
71048,Jagodina,51,,338,162,338,176,176,3,173,86,87
71048,Jagodina,52,,121,67,121,54,54,0,54,48,6
71048,Jagodina,53,,527,290,527,237,237,4,233,116,117
71048,Jagodina,54,,171,98,171,73,73,1,72,35,37
71048,Jagodina,55,,238,119,238,119,119,0,119,88,31
71048,Jagodina,56,,605,330,605,275,275,1,274,180,94
71048,Jagodina,57,,286,160,286,126,126,1,125,99,26
71048,Jagodina,58,,869,506,869,363,363,3,360,201,159
71048,Jagodina,59,,556,294,555,262,262,2,260,187,73
71048,Jagodina,60,,1432,706,1432,726,726,9,717,292,425
71048,Jagodina,61,,989,447,989,542,542,6,536,191,345
71048,Jagodina,62,,1087,522,1087,565,565,4,561,208,353
71048,Jagodina,63,,1004,462,1004,542,542,7,535,205,330
71048,Jagodina,64,,937,417,937,520,520,9,511,214,297
71048,Jagodina,65,,1144,600,1144,544,544,6,538,178,360
71048,Jagodina,66,,1070,527,1071,543,543,6,537,247,290
71048,Jagodina,67,,1444,669,1449,775,775,9,766,320,446
71048,Jagodina,68,,1108,531,1109,577,577,7,570,250,320
71048,Jagodina,69,,1071,515,1072,556,556,8,548,237,311
71048,Jagodina,70,,879,463,882,416,416,8,408,171,237
71048,Jagodina,71,,722,386,722,336,336,4,332,123,209
71048,Jagodina,72,,555,292,555,263,263,4,259,97,162
71048,Jagodina,73,,1290,620,1290,670,670,11,659,284,375
71048,Jagodina,74,,1081,569,1082,512,512,3,509,222,287
71048,Jagodina,75,,1425,705,1425,720,720,13,707,276,431
71048,Jagodina,76,,1055,531,1055,524,524,7,517,232,285
71048,Jagodina,77,,1188,628,1191,560,560,5,555,216,339
71048,Jagodina,78,,847,375,847,472,472,8,464,157,307
71048,Jagodina,79,,861,449,861,412,412,12,400,131,269
71048,Jagodina,80,,1364,733,1364,631,631,7,624,278,346
71048,Jagodina,81,,1014,471,1013,543,543,8,535,209,326
71048,Jagodina,82,,945,520,946,425,425,9,416,195,221
71048,Jagodina,83,,1068,505,1067,563,563,4,559,238,321
71048,Jagodina,84,,1127,628,1129,499,499,3,496,259,237
71048,Jagodina,85,,898,420,898,478,478,15,463,191,272
71048,Jagodina,86,,859,418,861,441,440,10,430,137,293
71048,Jagodina,87,,1047,529,1047,518,518,3,515,208,307
71048,Jagodina,88,,906,424,906,482,482,4,478,187,291
71048,Jagodina,89,,1176,641,1177,535,534,3,531,156,375
71048,Jagodina,90,,746,420,748,326,326,4,322,244,78
71048,Jagodina,91,,268,141,277,127,127,1,126,92,34
71056,Svilajnac,1,,1266,619,1269,647,647,12,635,285,350
71056,Svilajnac,2,,1279,668,1279,611,611,4,607,245,362
71056,Svilajnac,3,,1283,722,1283,561,561,11,550,263,287
71056,Svilajnac,4,,1269,634,1269,635,635,9,626,268,358
71056,Svilajnac,5,,1307,662,1307,645,645,12,633,320,313
71056,Svilajnac,6,,1206,679,1207,527,527,7,520,284,236
71056,Svilajnac,7,,1325,686,1325,639,639,10,629,320,309
71056,Svilajnac,8,,1190,700,1190,490,490,10,480,237,243
71056,Svilajnac,9,,1207,685,1207,522,522,9,513,287,226
71056,Svilajnac,10,,968,522,968,446,446,4,442,212,230
71056,Svilajnac,11,,781,529,781,252,252,2,250,146,104
71056,Svilajnac,12,,1270,782,1270,488,488,14,474,236,238
71056,Svilajnac,13,,1217,698,1217,519,519,11,508,221,287
71056,Svilajnac,14,,1201,759,1201,442,442,7,435,206,229
71056,Svilajnac,15,,1064,612,1064,452,452,15,437,225,212
71056,Svilajnac,16,,1001,628,1001,373,373,4,369,152,217
71056,Svilajnac,17,,936,524,936,412,412,12,400,211,189
71056,Svilajnac,18,,973,625,973,348,347,7,340,218,122
71056,Svilajnac,19,,778,404,778,374,374,9,365,197,168
71056,Svilajnac,20,,778,371,778,407,407,3,404,125,279
71056,Svilajnac,21,,759,445,758,314,314,7,307,116,191
71056,Svilajnac,22,,648,386,648,262,262,4,258,160,98
71056,Svilajnac,23,,611,413,611,198,198,4,194,95,99
71056,Svilajnac,24,,439,189,439,250,250,23,227,145,82
71056,Svilajnac,25,,401,207,401,194,194,4,190,112,78
71056,Svilajnac,26,,352,171,352,181,181,4,177,102,75
71056,Svilajnac,27,,334,155,334,179,179,0,179,92,87
71056,Svilajnac,28,,299,137,299,162,137,1,136,77,59
71056,Svilajnac,29,,270,145,270,125,125,3,122,69,53
71056,Svilajnac,30,,239,127,239,112,112,1,111,61,50
71064,Svrljig,1,,299,161,299,138,138,2,136,102,34
71064,Svrljig,2,,260,162,260,98,98,0,98,65,33
71064,Svrljig,3,,549,404,549,145,145,0,145,101,44
71064,Svrljig,4,,140,90,140,50,50,0,50,39,11
71064,Svrljig,5,,239,165,239,74,74,2,72,62,10
71064,Svrljig,6,,142,86,142,56,56,0,56,35,21
71064,Svrljig,7,,218,135,218,83,83,1,82,58,24
71064,Svrljig,8,,278,186,278,92,92,2,90,70,20
71064,Svrljig,9,,469,290,469,179,179,2,177,136,41
71064,Svrljig,10,,187,120,187,67,67,0,67,37,30
71064,Svrljig,11,,174,112,174,62,62,0,62,45,17
71064,Svrljig,12,,294,172,294,122,122,0,122,74,48
71064,Svrljig,13,,167,119,167,48,48,1,47,31,16
71064,Svrljig,14,,162,87,162,75,75,0,75,58,17
71064,Svrljig,15,,582,345,582,237,237,5,232,181,51
71064,Svrljig,16,,105,33,105,72,72,1,71,56,15
71064,Svrljig,17,,259,193,259,66,66,1,65,29,36
71064,Svrljig,18,,349,221,349,128,128,1,127,99,28
71064,Svrljig,19,,100,61,100,39,39,0,39,37,2
71064,Svrljig,20,,114,69,114,45,45,0,45,24,21
71064,Svrljig,21,,432,243,432,189,189,5,184,112,72
71064,Svrljig,22,,193,111,193,82,82,1,81,44,37
71064,Svrljig,23,,203,121,203,82,82,1,81,50,31
71064,Svrljig,24,,228,187,228,41,41,0,41,34,7
71064,Svrljig,25,,205,146,205,59,59,2,57,35,22
71064,Svrljig,26,,331,190,331,141,141,5,136,115,21
71064,Svrljig,27,,504,257,504,247,247,5,242,154,88
71064,Svrljig,28,,285,180,285,105,105,0,105,68,37
71064,Svrljig,29,,127,71,127,56,56,2,54,19,35
71064,Svrljig,30,,173,111,173,62,62,1,61,26,35
71064,Svrljig,31,,648,428,648,220,220,4,216,80,136
71064,Svrljig,32,,612,327,612,285,285,3,282,121,161
71064,Svrljig,33,,730,405,730,325,325,4,321,202,119
71064,Svrljig,34,,765,418,765,347,347,3,344,152,192
71064,Svrljig,35,,380,210,380,170,170,2,168,83,85
71064,Svrljig,36,,573,341,573,232,232,4,228,136,92
71064,Svrljig,37,,137,64,137,73,73,1,72,51,21
71064,Svrljig,38,,726,465,726,261,261,4,257,103,154
71064,Svrljig,39,,600,350,600,250,250,3,247,104,143
71064,Svrljig,40,,182,96,182,86,86,1,85,56,29
71064,Svrljig,41,,702,407,702,295,295,4,291,156,135
71064,Svrljig,42,,879,469,879,410,410,4,406,180,226
71072,Sjenica,1,,137,103,137,34,34,0,34,3,31
71072,Sjenica,2,,163,92,163,71,71,0,71,66,5
71072,Sjenica,3,,113,14,113,99,99,1,98,81,17
71072,Sjenica,4,,130,67,130,63,63,0,63,57,6
71072,Sjenica,5,,151,88,151,63,63,0,63,57,6
71072,Sjenica,6,,124,100,124,24,24,0,24,23,1
71072,Sjenica,7,,104,51,104,53,53,0,53,48,5
71072,Sjenica,8,,118,18,118,100,100,0,100,83,17
71072,Sjenica,9,,153,125,153,28,28,0,28,17,11
71072,Sjenica,10,,151,41,151,110,110,0,110,0,110
71072,Sjenica,11,,105,25,105,80,80,1,79,0,79
71072,Sjenica,12,,100,35,100,65,65,0,65,4,61
71072,Sjenica,13,,198,80,198,118,118,0,118,48,70
71072,Sjenica,14,,192,39,192,153,153,0,153,127,26
71072,Sjenica,15,,132,35,132,97,97,0,97,17,80
71072,Sjenica,16,,252,85,252,167,167,0,167,130,37
71072,Sjenica,17,,341,166,341,175,175,0,175,41,134
71072,Sjenica,18,,548,333,548,215,215,2,213,13,200
71072,Sjenica,19,,268,173,268,95,95,1,94,2,92
71072,Sjenica,20,,330,114,330,216,216,2,214,0,214
71072,Sjenica,21,,368,172,368,196,196,0,196,0,196
71072,Sjenica,22,,423,152,423,271,271,0,271,3,268
71072,Sjenica,23,,373,136,373,237,237,2,235,9,226
71072,Sjenica,24,,196,137,196,59,59,0,59,4,55
71072,Sjenica,25,,457,298,457,159,159,2,157,5,152
71072,Sjenica,26,,101,49,101,52,52,0,52,48,4
71072,Sjenica,27,,160,55,160,105,105,0,105,0,105
71072,Sjenica,28,,175,7,175,168,168,0,168,6,162
71072,Sjenica,29,,218,107,218,111,111,0,111,0,111
71072,Sjenica,30,,306,169,306,137,137,1,136,14,122
71072,Sjenica,31,,405,132,405,273,273,0,273,11,262
71072,Sjenica,32,,194,59,194,135,135,1,134,3,131
71072,Sjenica,33,,196,115,196,81,81,0,81,10,71
71072,Sjenica,34,,104,33,104,71,71,0,71,64,7
71072,Sjenica,35,,163,43,163,120,120,0,120,116,4
71072,Sjenica,36,,248,140,248,108,108,1,107,4,103
71072,Sjenica,37,,295,175,295,120,120,0,120,9,111
71072,Sjenica,38,,139,50,139,89,89,0,89,0,89
71072,Sjenica,39,,186,0,186,186,186,0,186,25,161
71072,Sjenica,40,,437,262,437,175,175,1,174,9,165
71072,Sjenica,41,,169,45,169,124,124,0,124,25,99
71072,Sjenica,42,,176,10,176,166,166,0,166,3,163
71072,Sjenica,43,,262,80,262,182,182,0,182,2,180
71072,Sjenica,44,,396,292,396,104,104,0,104,4,100
71072,Sjenica,45,,354,122,354,232,232,0,232,2,230
71072,Sjenica,46,,505,284,505,221,221,0,221,6,215
71072,Sjenica,47,,162,100,162,62,62,1,61,0,61
71072,Sjenica,48,,161,81,161,80,80,0,80,20,60
71072,Sjenica,49,,196,108,196,88,88,0,88,4,84
71072,Sjenica,50,,137,21,137,116,116,0,116,104,12
71072,Sjenica,51,,148,33,148,115,115,1,114,106,8
71072,Sjenica,52,,250,49,250,201,201,12,189,158,31
71072,Sjenica,53,,101,22,101,79,79,0,79,79,0
71072,Sjenica,54,,105,3,105,102,102,4,98,85,13
71072,Sjenica,55,,100,29,100,71,71,1,70,57,13
71072,Sjenica,56,,148,51,148,97,97,0,97,92,5
71072,Sjenica,57,,1515,857,1515,658,658,2,656,143,513
71072,Sjenica,58,,999,604,999,395,395,0,395,123,272
71072,Sjenica,59,,678,419,678,259,259,0,259,22,237
71072,Sjenica,60,,518,318,518,200,200,9,191,4,187
71072,Sjenica,61,,782,449,782,333,333,4,329,1,328
71072,Sjenica,62,,574,334,574,240,240,0,240,3,237
71072,Sjenica,63,,540,344,540,196,196,0,196,11,185
71072,Sjenica,64,,704,462,704,242,242,0,242,6,236
71072,Sjenica,65,,1213,700,1213,513,513,4,509,64,445
71072,Sjenica,66,,891,550,891,341,341,0,341,64,277
71072,Sjenica,67,,449,276,449,173,173,0,173,13,160
71072,Sjenica,68,,722,375,722,347,347,2,345,50,295
71072,Sjenica,69,,1217,712,1217,505,505,2,503,182,321
71072,Sjenica,70,,843,422,843,421,421,8,413,37,376
71072,Sjenica,71,,638,376,638,262,262,3,259,139,120
71099,Smederevo,1,,1238,603,1238,635,635,10,625,177,448
71099,Smederevo,2,,1373,609,1373,764,764,6,758,216,542
71099,Smederevo,3,,1256,549,1256,707,707,8,699,211,488
71099,Smederevo,4,,1659,741,1659,918,917,8,909,317,592
71099,Smederevo,5,,1450,591,1450,859,858,12,846,222,624
71099,Smederevo,6,,1649,837,1649,812,812,12,800,277,523
71099,Smederevo,7,,1361,600,1360,761,761,8,753,261,492
71099,Smederevo,8,,1171,520,1171,651,651,15,636,188,448
71099,Smederevo,9,,1441,869,1441,572,572,7,565,249,316
71099,Smederevo,10,,778,431,778,347,347,1,346,150,196
71099,Smederevo,11,,771,546,771,225,225,2,223,155,68
71099,Smederevo,12,,1344,620,1344,724,724,12,712,207,505
71099,Smederevo,13,,1461,817,1461,644,644,7,637,250,387
71099,Smederevo,14,,2051,1176,2049,875,875,7,868,472,396
71099,Smederevo,15,,1519,832,1519,687,687,4,683,350,333
71099,Smederevo,16,,1364,697,1364,667,667,11,656,292,364
71099,Smederevo,17,,1663,892,1663,771,770,10,760,358,402
71099,Smederevo,18,,1402,769,1402,633,633,7,626,281,345
71099,Smederevo,19,,1513,808,1513,705,705,9,696,273,423
71099,Smederevo,20,,2007,1179,2007,828,828,8,820,379,441
71099,Smederevo,21,,1527,702,1527,825,825,21,804,239,565
71099,Smederevo,22,,1661,784,1668,877,877,20,857,311,546
71099,Smederevo,23,,1646,830,1646,816,816,19,797,350,447
71099,Smederevo,24,,1484,796,1484,688,688,11,677,301,376
71099,Smederevo,25,,1174,849,1174,325,325,9,316,200,116
71099,Smederevo,26,,1847,926,1847,921,921,15,906,498,408
71099,Smederevo,27,,1612,954,1612,658,658,5,653,454,199
71099,Smederevo,28,,1548,915,1548,633,633,14,619,366,253
71099,Smederevo,29,,1427,896,1427,531,531,7,524,322,202
71099,Smederevo,30,,1416,783,1416,633,633,4,629,354,275
71099,Smederevo,31,,1380,663,1380,717,716,17,699,274,425
71099,Smederevo,32,,1356,673,1356,683,683,4,679,265,414
71099,Smederevo,33,,1354,657,1354,697,697,9,688,257,431
71099,Smederevo,34,,1714,1039,1714,675,675,6,669,310,359
71099,Smederevo,35,,2279,1371,2279,908,908,4,904,567,337
71099,Smederevo,36,,1758,1043,1758,715,715,3,712,486,226
71099,Smederevo,37,,1481,883,1481,598,598,7,591,391,200
71099,Smederevo,38,,1923,1113,1924,810,810,5,805,572,233
71099,Smederevo,39,,1840,1165,1840,675,675,9,666,505,161
71099,Smederevo,40,,1561,1164,1563,397,397,5,392,195,197
71099,Smederevo,41,,1484,1072,1484,412,412,10,402,238,164
71099,Smederevo,42,,1450,1045,1450,405,405,6,399,246,153
71099,Smederevo,43,,1393,767,1393,626,626,12,614,426,188
71099,Smederevo,44,,1271,765,1271,506,505,10,495,277,218
71099,Smederevo,45,,1222,710,1219,512,512,7,505,311,194
71099,Smederevo,46,,1082,613,1082,469,469,5,464,280,184
71099,Smederevo,47,,1652,935,1652,717,717,6,711,484,227
71099,Smederevo,48,,1342,820,1342,522,522,2,520,359,161
71099,Smederevo,49,,1538,999,1538,539,535,4,531,431,100
71099,Smederevo,50,,1430,808,1430,622,621,7,614,338,276
71099,Smederevo,51,,1665,1057,1665,608,607,13,594,282,312
71099,Smederevo,52,,1292,800,1292,492,492,10,482,277,205
71099,Smederevo,53,,1332,873,1332,459,459,5,454,304,150
71099,Smederevo,54,,1391,1046,1391,345,345,4,341,226,115
71099,Smederevo,55,,1224,690,1233,534,534,8,526,377,149
71099,Smederevo,56,,326,163,329,163,163,3,160,89,71
71099,Smederevo,57,,328,136,328,192,192,6,186,116,70
71099,Smederevo,58,,556,307,556,249,249,4,245,138,107
71099,Smederevo,59,,291,164,286,127,127,1,126,92,34
71099,Smederevo,60,,646,313,646,333,333,4,329,190,139
71099,Smederevo,61,,512,250,512,262,262,1,261,103,158
71099,Smederevo,62,,668,346,668,322,322,7,315,163,152
71099,Smederevo,63,,948,599,945,349,349,4,345,191,154
71099,Smederevo,64,,990,529,990,461,461,9,452,249,203
71099,Smederevo,65,,474,260,474,214,214,4,210,137,73
71099,Smederevo,66,,1032,767,1032,265,265,6,259,126,133
71099,Smederevo,67,,1227,952,1227,275,275,2,273,139,134
71099,Smederevo,68,,946,656,949,290,290,1,289,135,154
71099,Smederevo,69,,1039,619,1039,420,420,12,408,235,173
71099,Smederevo,70,,1053,605,1053,448,448,7,441,236,205
71099,Smederevo,71,,1141,638,1141,503,503,13,490,360,130
71099,Smederevo,72,,946,596,946,350,350,11,339,147,192
71099,Smederevo,73,,1215,693,1215,522,522,7,515,367,148
71099,Smederevo,74,,407,248,407,159,159,0,159,79,80
71099,Smederevo,75,,445,222,445,223,223,4,219,100,119
71099,Smederevo,76,,1074,719,1073,355,355,4,351,197,154
71099,Smederevo,77,,887,524,887,363,362,7,355,179,176
71102,Smederevska Palanka,1,,713,506,713,207,207,3,204,95,109
71102,Smederevska Palanka,2,,497,309,497,188,188,1,187,119,68
71102,Smederevska Palanka,3,,626,387,627,239,239,5,234,134,100
71102,Smederevska Palanka,4,,903,637,903,266,266,3,263,128,135
71102,Smederevska Palanka,5,,1090,702,1090,388,388,10,378,206,172
71102,Smederevska Palanka,6,,960,682,960,278,278,4,274,97,177
71102,Smederevska Palanka,7,,606,309,606,297,297,9,288,213,75
71102,Smederevska Palanka,8,,497,273,497,224,224,10,214,92,122
71102,Smederevska Palanka,9,,913,638,913,275,275,9,266,151,115
71102,Smederevska Palanka,10,,892,469,892,423,423,6,417,206,211
71102,Smederevska Palanka,11,,538,257,538,281,281,7,274,134,140
71102,Smederevska Palanka,12,,402,214,402,188,188,4,184,99,85
71102,Smederevska Palanka,13,,469,232,469,237,237,9,228,125,103
71102,Smederevska Palanka,14,,462,232,462,230,230,6,224,101,123
71102,Smederevska Palanka,15,,618,426,618,192,192,1,191,100,91
71102,Smederevska Palanka,16,,354,239,354,115,115,0,115,62,53
71102,Smederevska Palanka,17,,540,360,540,180,180,3,177,97,80
71102,Smederevska Palanka,18,,435,259,435,176,176,4,172,95,77
71102,Smederevska Palanka,19,,739,495,739,244,244,4,240,128,112
71102,Smederevska Palanka,20,,188,106,188,82,82,0,82,39,43
71102,Smederevska Palanka,21,,689,468,689,221,221,3,218,123,95
71102,Smederevska Palanka,22,,757,506,757,251,251,5,246,152,94
71102,Smederevska Palanka,23,,724,494,724,230,230,0,230,112,118
71102,Smederevska Palanka,24,,876,627,876,249,249,2,247,110,137
71102,Smederevska Palanka,25,,1159,749,1159,410,410,8,402,175,227
71102,Smederevska Palanka,26,,731,359,731,372,372,4,368,221,147
71102,Smederevska Palanka,27,,535,295,535,240,240,13,227,110,117
71102,Smederevska Palanka,28,,848,563,849,285,285,7,278,144,134
71102,Smederevska Palanka,29,,819,527,819,292,292,8,284,148,136
71102,Smederevska Palanka,30,,494,292,497,202,202,4,198,82,116
71102,Smederevska Palanka,31,,291,156,291,135,135,3,132,56,76
71102,Smederevska Palanka,32,,163,106,163,57,57,0,57,38,19
71102,Smederevska Palanka,33,,750,443,750,307,307,8,299,132,167
71102,Smederevska Palanka,34,,852,479,852,373,373,4,369,185,184
71102,Smederevska Palanka,35,,808,441,808,367,367,4,363,140,223
71102,Smederevska Palanka,36,,707,426,707,281,281,3,278,188,90
71102,Smederevska Palanka,37,,428,235,428,193,192,4,188,88,100
71102,Smederevska Palanka,38,,999,592,999,407,407,3,404,115,289
71102,Smederevska Palanka,39,,1163,544,1163,619,619,21,598,219,379
71102,Smederevska Palanka,40,,1189,685,1189,504,504,7,497,278,219
71102,Smederevska Palanka,41,,1256,609,1256,647,647,9,638,289,349
71102,Smederevska Palanka,42,,1515,700,1516,815,815,19,796,386,410
71102,Smederevska Palanka,43,,985,520,985,465,465,3,462,241,221
71102,Smederevska Palanka,44,,1077,579,1078,498,498,11,487,190,297
71102,Smederevska Palanka,45,,896,388,896,508,508,7,501,184,317
71102,Smederevska Palanka,46,,1034,506,1034,528,528,16,512,201,311
71102,Smederevska Palanka,47,,908,415,909,493,493,11,482,208,274
71102,Smederevska Palanka,48,,1332,604,1331,728,728,16,712,248,464
71102,Smederevska Palanka,49,,1055,513,1045,542,542,10,532,227,305
71102,Smederevska Palanka,50,,1291,654,1291,637,637,14,623,281,342
71102,Smederevska Palanka,51,,1180,630,1180,550,549,5,544,279,265
71102,Smederevska Palanka,52,,850,359,850,491,491,9,482,169,313
71102,Smederevska Palanka,53,,1070,501,1070,569,569,6,563,207,356
71102,Smederevska Palanka,54,,1497,824,1497,673,673,5,668,290,378
71102,Smederevska Palanka,55,,931,424,931,507,507,7,500,178,322
71102,Smederevska Palanka,56,,1256,665,1256,591,591,8,583,340,243
71102,Smederevska Palanka,57,,1204,583,1206,621,621,12,609,264,345
71129,Sokobanja,1,,614,336,614,278,278,2,276,151,125
71129,Sokobanja,2,,695,397,695,298,298,2,296,175,121
71129,Sokobanja,3,,742,439,742,303,302,2,300,144,156
71129,Sokobanja,4,,600,309,600,291,291,9,282,128,154
71129,Sokobanja,5,,620,336,620,284,284,2,282,135,147
71129,Sokobanja,6,,607,318,607,289,289,9,280,145,135
71129,Sokobanja,7,,645,315,645,330,330,3,327,151,176
71129,Sokobanja,8,,640,329,640,311,311,7,304,153,151
71129,Sokobanja,9,,648,330,648,318,318,4,314,161,153
71129,Sokobanja,10,,647,374,647,273,273,4,269,134,135
71129,Sokobanja,11,,642,388,643,254,254,3,251,123,128
71129,Sokobanja,12,,611,381,619,230,230,2,228,153,75
71129,Sokobanja,13,,545,352,545,193,193,9,184,90,94
71129,Sokobanja,14,,358,205,358,153,153,2,151,78,73
71129,Sokobanja,15,,330,243,330,87,87,0,87,75,12
71129,Sokobanja,16,,100,69,100,31,31,0,31,21,10
71129,Sokobanja,17,,264,170,264,94,94,2,92,56,36
71129,Sokobanja,18,,168,80,168,88,88,1,87,75,12
71129,Sokobanja,19,,413,261,413,152,152,2,150,97,53
71129,Sokobanja,20,,170,66,170,104,104,4,100,52,48
71129,Sokobanja,21,,292,144,292,148,148,2,146,53,93
71129,Sokobanja,22,,296,107,296,189,189,3,186,90,96
71129,Sokobanja,23,,327,228,327,99,99,4,95,50,45
71129,Sokobanja,24,,586,316,586,270,270,4,266,133,133
71129,Sokobanja,25,,364,220,364,144,144,2,142,95,47
71129,Sokobanja,26,,466,296,466,170,170,2,168,123,45
71129,Sokobanja,27,,398,270,398,128,128,0,128,84,44
71129,Sokobanja,28,,304,208,304,96,96,2,94,47,47
71129,Sokobanja,29,,192,121,192,71,71,0,71,54,17
71129,Sokobanja,30,,240,132,240,108,108,2,106,67,39
71129,Sokobanja,31,,317,209,317,108,108,4,104,73,31
71129,Sokobanja,32,,462,238,462,224,224,4,220,115,105
71129,Sokobanja,33,,580,427,580,153,153,2,151,109,42
71129,Sokobanja,34,,513,281,513,232,232,3,229,169,60
71129,Sokobanja,35,,304,181,304,123,123,2,121,76,45
71129,Sokobanja,36,,232,130,232,102,102,3,99,74,25
71129,Sokobanja,37,,720,489,711,231,231,6,225,117,108
71137,Surdulica,1,,891,592,891,299,299,2,297,178,119
71137,Surdulica,2,,562,283,562,279,279,7,272,156,116
71137,Surdulica,3,,652,447,652,205,205,2,203,125,78
71137,Surdulica,4,,576,263,574,313,313,2,311,190,121
71137,Surdulica,5,,520,291,520,229,229,3,226,120,106
71137,Surdulica,6,,936,448,947,488,488,5,483,262,221
71137,Surdulica,7,,691,355,691,336,336,5,331,175,156
71137,Surdulica,8,,691,302,691,389,389,7,382,187,195
71137,Surdulica,9,,735,427,734,308,308,3,305,169,136
71137,Surdulica,10,,765,362,765,403,403,7,396,180,216
71137,Surdulica,11,,790,448,790,342,342,1,341,223,118
71137,Surdulica,12,,615,314,615,301,301,5,296,157,139
71137,Surdulica,13,,343,171,343,172,172,4,168,111,57
71137,Surdulica,14,,492,241,493,251,251,4,247,161,86
71137,Surdulica,15,,568,345,568,223,223,6,217,146,71
71137,Surdulica,16,,486,408,486,78,78,0,78,62,16
71137,Surdulica,17,,443,304,443,139,139,4,135,74,61
71137,Surdulica,18,,557,322,559,235,235,4,231,155,76
71137,Surdulica,19,,557,278,557,279,279,5,274,189,85
71137,Surdulica,20,,510,325,510,185,185,2,183,109,74
71137,Surdulica,21,,294,226,294,68,68,0,68,49,19
71137,Surdulica,22,,225,96,225,129,129,0,129,77,52
71137,Surdulica,23,,735,342,735,393,393,13,380,224,156
71137,Surdulica,24,,137,51,137,86,86,0,86,75,11
71137,Surdulica,25,,103,75,103,28,28,0,28,18,10
71137,Surdulica,26,,159,108,159,51,51,0,51,42,9
71137,Surdulica,27,,309,223,309,86,86,0,86,60,26
71137,Surdulica,28,,102,43,102,59,59,0,59,42,17
71137,Surdulica,29,,130,83,130,47,47,0,47,38,9
71137,Surdulica,30,,512,262,512,250,250,4,246,186,60
71137,Surdulica,31,,435,160,435,275,275,7,268,170,98
71137,Surdulica,32,,103,37,103,66,66,1,65,64,1
71137,Surdulica,33,,384,177,384,207,207,1,206,117,89
71137,Surdulica,34,,127,110,127,17,17,0,17,14,3
71137,Surdulica,35,,120,84,120,36,36,0,36,26,10
71137,Surdulica,36,,121,80,121,41,41,0,41,35,6
71137,Surdulica,37,,150,82,150,68,68,2,66,55,11
71137,Surdulica,38,,215,135,215,80,80,3,77,45,32
71137,Surdulica,39,,282,170,283,112,112,4,108,74,34
71137,Surdulica,40,,290,153,288,137,137,4,133,87,46
71137,Surdulica,41,,155,75,155,80,80,3,77,62,15
71137,Surdulica,42,,435,235,435,200,200,3,197,125,72
71137,Surdulica,43,,140,85,140,55,55,0,55,41,14
71137,Surdulica,44,,106,70,105,36,36,2,34,21,13
71145,Užice,1,,352,232,352,120,120,3,117,51,66
71145,Užice,2,,193,127,193,66,66,1,65,31,34
71145,Užice,3,,327,252,327,75,75,1,74,35,39
71145,Užice,4,,242,145,242,97,97,1,96,67,29
71145,Užice,5,,596,301,596,295,295,5,290,154,136
71145,Užice,6,,654,379,654,275,275,5,270,162,108
71145,Užice,7,,377,220,377,157,157,2,155,75,80
71145,Užice,8,,133,64,133,69,69,0,69,34,35
71145,Užice,9,,189,114,189,75,75,0,75,41,34
71145,Užice,10,,101,50,101,51,51,1,50,33,17
71145,Užice,11,,256,137,256,119,119,0,119,62,57
71145,Užice,12,,361,269,361,92,92,1,91,43,48
71145,Užice,13,,183,115,183,68,68,0,68,28,40
71145,Užice,14,,304,158,304,146,146,1,145,55,90
71145,Užice,15,,261,149,261,112,112,1,111,60,51
71145,Užice,16,,140,67,140,73,73,1,72,43,29
71145,Užice,17,,113,55,113,58,58,0,58,29,29
71145,Užice,18,,744,437,744,307,307,0,307,127,180
71145,Užice,19,,171,95,171,76,76,0,76,47,29
71145,Užice,20,,196,119,196,77,77,0,77,30,47
71145,Užice,21,,402,275,402,127,127,0,127,50,77
71145,Užice,22,,172,91,172,81,81,1,80,30,50
71145,Užice,23,,168,91,168,77,77,1,76,22,54
71145,Užice,24,,167,86,167,81,81,1,80,34,46
71145,Užice,25,,241,114,241,127,127,0,127,66,61
71145,Užice,26,,248,168,248,80,80,1,79,30,49
71145,Užice,27,,316,228,316,88,88,2,86,36,50
71145,Užice,28,,683,457,683,226,226,1,225,119,106
71145,Užice,29,,355,215,355,140,140,1,139,74,65
71145,Užice,30,,791,495,791,296,296,1,295,153,142
71145,Užice,31,,934,556,934,378,378,6,372,224,148
71145,Užice,32,,679,415,679,264,264,1,263,106,157
71145,Užice,33,,557,293,557,264,264,5,259,116,143
71145,Užice,34,,265,147,265,118,118,3,115,32,83
71145,Užice,35,,417,243,417,174,174,3,171,82,89
71145,Užice,36,,371,243,371,128,128,1,127,53,74
71145,Užice,37,,635,393,635,242,242,0,242,88,154
71145,Užice,38,,441,283,441,158,158,2,156,44,112
71145,Užice,39,,116,59,116,57,57,0,57,23,34
71145,Užice,40,,364,214,364,150,150,1,149,68,81
71145,Užice,41,,449,310,449,139,139,2,137,69,68
71145,Užice,42,,290,201,290,89,89,2,87,39,48
71145,Užice,43,,207,122,207,85,85,2,83,63,20
71145,Užice,44,,133,77,133,56,56,0,56,23,33
71145,Užice,45,,458,267,479,191,191,1,190,100,90
71145,Užice,46,,114,68,114,46,46,0,46,30,16
71145,Užice,47,,749,428,749,321,321,5,316,93,223
71145,Užice,48,,903,552,903,351,351,6,345,149,196
71145,Užice,49,,1426,735,1425,691,691,7,684,228,456
71145,Užice,50,,1624,860,1624,764,764,4,760,235,525
71145,Užice,51,,1162,595,1162,567,567,6,561,217,344
71145,Užice,52,,898,506,898,392,392,1,391,154,237
71145,Užice,53,,1268,757,1268,511,511,2,509,186,323
71145,Užice,54,,1757,1022,1757,735,735,17,718,267,451
71145,Užice,55,,1631,905,1631,726,726,6,720,311,409
71145,Užice,56,,1028,512,1028,516,516,9,507,136,371
71145,Užice,57,,1246,590,1246,656,656,3,653,175,478
71145,Užice,58,,1799,881,1799,918,918,15,903,270,633
71145,Užice,59,,1084,595,1084,489,489,13,476,153,323
71145,Užice,60,,1063,430,1063,633,633,15,618,193,425
71145,Užice,61,,1064,515,1064,549,549,7,542,148,394
71145,Užice,62,,1314,782,1315,532,532,4,528,228,300
71145,Užice,63,,997,580,977,417,417,9,408,140,268
71145,Užice,64,,826,366,826,460,460,7,453,111,342
71145,Užice,65,,1168,546,1168,622,622,4,618,154,464
71145,Užice,66,,1522,918,1522,604,604,4,600,189,411
71145,Užice,67,,1337,798,1337,539,539,1,538,166,372
71145,Užice,68,,1113,512,1113,601,601,11,590,185,405
71145,Užice,69,,924,429,924,495,495,7,488,160,328
71145,Užice,70,,983,467,984,516,515,8,507,148,359
71145,Užice,71,,1024,521,1024,503,503,5,498,143,355
71145,Užice,72,,1249,608,1249,641,641,7,634,251,383
71145,Užice,73,,1257,647,1257,610,610,10,600,198,402
71145,Užice,74,,1400,775,1400,625,625,8,617,173,444
71145,Užice,75,,1082,625,1082,457,457,2,455,194,261
71145,Užice,76,,1170,629,1170,541,541,4,537,166,371
71145,Užice,77,,899,407,899,492,492,6,486,176,310
71145,Užice,78,,1363,700,1363,663,662,5,657,238,419
71145,Užice,79,,1032,492,1032,540,540,6,534,144,390
71145,Užice,80,,988,432,988,556,556,10,546,139,407
71145,Užice,81,,1078,453,1078,625,624,8,616,191,425
71145,Užice,82,,1024,515,1024,509,509,5,504,129,375
71145,Užice,83,,929,433,929,496,496,12,484,168,316
71145,Užice,84,,895,403,895,492,492,13,479,157,322
71145,Užice,85,,1130,543,1130,587,587,5,582,197,385
71145,Užice,86,,1397,778,1397,619,619,5,614,186,428
71145,Užice,87,,1152,610,1152,542,542,6,536,163,373
71145,Užice,88,,1607,887,1607,720,720,11,709,258,451
71145,Užice,89,,761,397,761,364,364,2,362,143,219
71145,Užice,90,,812,489,812,323,323,4,319,114,205
71145,Užice,91,,1569,899,1569,670,670,7,663,229,434
71145,Užice,92,,846,508,848,338,338,4,334,140,194
71153,Topola,1,,439,201,439,238,238,3,235,124,111
71153,Topola,2,,419,251,421,168,168,1,167,63,104
71153,Topola,3,,533,255,533,278,278,3,275,60,215
71153,Topola,4,,639,352,639,287,287,4,283,114,169
71153,Topola,5,,568,377,568,191,191,3,188,73,115
71153,Topola,6,,397,247,397,150,150,2,148,68,80
71153,Topola,7,,188,56,188,132,132,1,131,37,94
71153,Topola,8,,505,255,505,250,250,9,241,120,121
71153,Topola,9,,573,340,574,233,233,2,231,82,149
71153,Topola,10,,798,517,798,281,281,4,277,132,145
71153,Topola,11,,351,178,351,173,173,1,172,82,90
71153,Topola,12,,351,249,351,102,102,1,101,63,38
71153,Topola,13,,440,254,441,186,186,5,181,88,93
71153,Topola,14,,604,318,605,286,286,6,280,84,196
71153,Topola,15,,397,186,397,211,211,3,208,106,102
71153,Topola,16,,396,180,396,216,216,4,212,81,131
71153,Topola,17,,256,154,256,102,102,3,99,45,54
71153,Topola,18,,250,136,250,114,114,1,113,50,63
71153,Topola,19,,241,103,241,138,138,4,134,50,84
71153,Topola,20,,377,172,377,205,205,5,200,51,149
71153,Topola,21,,247,122,247,125,125,1,124,59,65
71153,Topola,22,,380,197,380,183,183,3,180,64,116
71153,Topola,23,,328,194,329,134,134,1,133,38,95
71153,Topola,24,,423,223,423,200,200,1,199,92,107
71153,Topola,25,,411,245,411,166,166,3,163,94,69
71153,Topola,26,,544,293,544,251,251,7,244,132,112
71153,Topola,27,,386,183,386,203,203,5,198,76,122
71153,Topola,28,,175,68,175,107,107,1,106,60,46
71153,Topola,29,,311,146,311,165,165,2,163,92,71
71153,Topola,30,,412,212,412,200,200,1,199,121,78
71153,Topola,31,,514,351,514,163,163,3,160,65,95
71153,Topola,32,,446,267,446,179,179,3,176,71,105
71153,Topola,33,,151,58,151,93,93,0,93,27,66
71153,Topola,34,,288,167,288,121,121,4,117,57,60
71153,Topola,35,,1568,671,1572,897,897,18,879,384,495
71153,Topola,36,,1214,564,1218,650,650,18,632,233,399
71153,Topola,37,,1290,574,1290,716,716,13,703,317,386
71153,Topola,38,,484,297,484,187,187,3,184,84,100
71153,Topola,39,,303,199,303,104,104,1,103,57,46
71153,Topola,40,,736,363,736,373,373,6,367,148,219
71153,Topola,41,,475,314,475,161,161,1,160,72,88
71153,Topola,42,,122,54,122,68,68,0,68,23,45
71161,Trgovište,1,,174,101,174,73,73,1,72,40,32
71161,Trgovište,2,,179,100,179,79,79,0,79,55,24
71161,Trgovište,3,,158,105,158,53,53,0,53,33,20
71161,Trgovište,4,,116,76,116,40,40,2,38,20,18
71161,Trgovište,5,,113,84,113,29,29,0,29,24,5
71161,Trgovište,6,,158,107,158,51,51,0,51,40,11
71161,Trgovište,7,,145,103,145,42,42,0,42,27,15
71161,Trgovište,8,,101,82,101,19,19,0,19,14,5
71161,Trgovište,9,,159,118,159,41,41,3,38,22,16
71161,Trgovište,10,,309,141,309,168,168,1,167,141,26
71161,Trgovište,11,,116,50,116,66,66,1,65,52,13
71161,Trgovište,12,,404,221,404,183,183,4,179,99,80
71161,Trgovište,13,,229,141,229,88,88,2,86,70,16
71161,Trgovište,14,,223,114,223,109,109,7,102,64,38
71161,Trgovište,15,,298,142,298,156,156,4,152,82,70
71161,Trgovište,16,,303,182,303,121,121,9,112,70,42
71161,Trgovište,17,,102,64,102,38,38,0,38,34,4
71161,Trgovište,18,,138,110,138,28,28,0,28,20,8
71161,Trgovište,19,,100,36,100,64,64,0,64,36,28
71161,Trgovište,20,,202,153,202,49,49,1,48,39,9
71161,Trgovište,21,,203,126,203,77,77,0,77,63,14
71161,Trgovište,22,,177,133,177,44,44,1,43,28,15
71161,Trgovište,23,,171,100,171,71,71,3,68,41,27
71161,Trgovište,24,,333,190,333,143,143,2,141,82,59
71161,Trgovište,25,,142,115,142,27,27,0,27,22,5
71161,Trgovište,26,,162,104,162,58,58,0,58,35,23
71170,Trstenik,1,,1264,589,1264,675,675,8,667,224,443
71170,Trstenik,2,,668,329,668,339,339,4,335,104,231
71170,Trstenik,3,,1110,512,1111,598,598,10,588,204,384
71170,Trstenik,4,,1073,513,1073,560,560,13,547,243,304
71170,Trstenik,5,,865,417,866,448,448,5,443,126,317
71170,Trstenik,6,,962,451,962,511,511,9,502,195,307
71170,Trstenik,7,,1090,575,1090,515,515,10,505,189,316
71170,Trstenik,8,,967,416,967,551,551,13,538,237,301
71170,Trstenik,9,,1246,669,1246,577,577,11,566,242,324
71170,Trstenik,10,,1334,713,1334,621,621,7,614,306,308
71170,Trstenik,11,,647,341,647,306,306,6,300,112,188
71170,Trstenik,12,,646,343,646,303,303,2,301,97,204
71170,Trstenik,13,,414,209,414,205,205,3,202,94,108
71170,Trstenik,14,,1029,674,1029,355,355,3,352,215,137
71170,Trstenik,15,,679,447,679,232,232,9,223,122,101
71170,Trstenik,16,,574,350,574,224,224,1,223,126,97
71170,Trstenik,17,,691,515,691,176,176,4,172,78,94
71170,Trstenik,18,,480,274,480,206,206,1,205,79,126
71170,Trstenik,19,,435,252,435,183,183,2,181,53,128
71170,Trstenik,20,,654,420,654,234,234,3,231,150,81
71170,Trstenik,21,,321,204,321,117,117,2,115,63,52
71170,Trstenik,22,,367,227,367,140,140,1,139,83,56
71170,Trstenik,23,,348,185,348,163,163,1,162,39,123
71170,Trstenik,24,,625,392,625,233,233,3,230,105,125
71170,Trstenik,25,,425,236,425,189,189,5,184,78,106
71170,Trstenik,26,,425,268,425,157,157,4,153,91,62
71170,Trstenik,27,,452,349,452,103,103,1,102,44,58
71170,Trstenik,28,,416,193,416,223,223,3,220,110,110
71170,Trstenik,29,,234,129,234,105,105,2,103,35,68
71170,Trstenik,30,,133,56,133,77,77,1,76,38,38
71170,Trstenik,31,,610,371,610,239,239,5,234,132,102
71170,Trstenik,32,,577,325,577,252,252,8,244,144,100
71170,Trstenik,33,,471,291,471,180,180,4,176,113,63
71170,Trstenik,34,,591,321,591,270,270,5,265,156,109
71170,Trstenik,35,,664,407,664,257,257,2,255,144,111
71170,Trstenik,36,,260,150,260,110,110,2,108,71,37
71170,Trstenik,37,,608,362,608,246,246,5,241,144,97
71170,Trstenik,38,,312,169,312,143,143,2,141,91,50
71170,Trstenik,39,,399,209,399,190,190,3,187,110,77
71170,Trstenik,40,,559,334,559,225,225,5,220,132,88
71170,Trstenik,41,,159,94,159,65,65,0,65,54,11
71170,Trstenik,42,,680,393,680,287,287,10,277,173,104
71170,Trstenik,43,,931,497,931,434,434,10,424,203,221
71170,Trstenik,44,,369,192,369,177,177,9,168,130,38
71170,Trstenik,45,,284,152,284,132,132,1,131,92,39
71170,Trstenik,46,,240,184,240,56,56,0,56,37,19
71170,Trstenik,47,,101,56,101,45,45,0,45,25,20
71170,Trstenik,48,,168,85,168,83,83,3,80,61,19
71170,Trstenik,49,,145,75,145,70,70,2,68,45,23
71170,Trstenik,50,,887,471,887,416,416,11,405,246,159
71170,Trstenik,51,,743,395,743,348,348,3,345,110,235
71170,Trstenik,52,,674,389,674,285,285,4,281,124,157
71170,Trstenik,53,,704,382,704,322,322,1,321,133,188
71170,Trstenik,54,,446,260,446,186,186,0,186,118,68
71170,Trstenik,55,,431,229,431,202,202,2,200,107,93
71170,Trstenik,56,,450,245,450,205,205,5,200,100,100
71170,Trstenik,57,,492,317,492,175,175,2,173,106,67
71170,Trstenik,58,,672,391,672,281,281,6,275,147,128
71170,Trstenik,59,,970,512,970,458,458,12,446,256,190
71170,Trstenik,60,,739,438,739,301,301,7,294,181,113
71170,Trstenik,61,,723,452,723,271,271,7,264,134,130
71170,Trstenik,62,,777,466,777,311,311,5,306,165,141
71170,Trstenik,63,,601,357,601,244,244,1,243,144,99
71170,Trstenik,64,,967,674,967,293,293,9,284,180,104
71170,Trstenik,65,,597,334,597,263,263,4,259,138,121
71170,Trstenik,66,,262,126,262,136,136,2,134,78,56
71170,Trstenik,67,,249,157,249,92,92,2,90,48,42
71188,Tutin,1,,838,456,838,382,382,1,381,2,379
71188,Tutin,2,,1341,725,1341,616,616,1,615,45,570
71188,Tutin,3,,1128,481,1128,647,647,3,644,55,589
71188,Tutin,4,,1202,685,1202,517,517,4,513,107,406
71188,Tutin,5,,616,262,616,354,354,0,354,8,346
71188,Tutin,6,,1212,698,1212,514,514,3,511,8,503
71188,Tutin,7,,901,561,901,340,340,0,340,3,337
71188,Tutin,8,,1277,713,1277,564,564,2,562,10,552
71188,Tutin,9,,1001,585,1001,416,416,0,416,3,413
71188,Tutin,10,,397,280,397,117,117,0,117,6,111
71188,Tutin,11,,120,19,120,101,101,0,101,0,101
71188,Tutin,12,,100,28,100,72,72,0,72,62,10
71188,Tutin,13,,146,52,146,94,94,1,93,62,31
71188,Tutin,14,,134,85,134,49,49,0,49,0,49
71188,Tutin,15,,230,127,230,103,103,0,103,0,103
71188,Tutin,16,,234,129,234,105,105,0,105,4,101
71188,Tutin,17,,252,107,252,145,145,0,145,17,128
71188,Tutin,18,,216,109,216,107,107,0,107,1,106
71188,Tutin,19,,121,28,121,93,93,0,93,10,83
71188,Tutin,20,,105,34,105,71,71,0,71,1,70
71188,Tutin,21,,205,128,205,77,77,0,77,0,77
71188,Tutin,22,,443,165,443,278,278,1,277,0,277
71188,Tutin,23,,612,225,612,387,387,1,386,13,373
71188,Tutin,24,,421,133,421,288,288,4,284,0,284
71188,Tutin,25,,371,151,372,220,220,2,218,3,215
71188,Tutin,26,,272,98,272,174,174,0,174,0,174
71188,Tutin,27,,176,14,176,162,162,0,162,0,162
71188,Tutin,28,,175,71,175,104,104,0,104,10,94
71188,Tutin,29,,228,53,228,175,175,0,175,2,173
71188,Tutin,30,,268,14,268,254,254,1,253,1,252
71188,Tutin,31,,204,22,204,182,182,0,182,0,182
71188,Tutin,32,,442,234,442,208,208,2,206,1,205
71188,Tutin,33,,192,71,192,121,121,1,120,7,113
71188,Tutin,34,,264,189,264,75,75,0,75,0,75
71188,Tutin,35,,475,275,475,200,200,0,200,2,198
71188,Tutin,36,,478,213,478,265,265,1,264,11,253
71188,Tutin,37,,258,155,258,103,103,0,103,3,100
71188,Tutin,38,,443,190,443,253,253,1,252,1,251
71188,Tutin,39,,301,154,301,147,147,1,146,0,146
71188,Tutin,40,,535,306,535,229,229,0,229,12,217
71188,Tutin,41,,401,159,401,242,242,0,242,2,240
71188,Tutin,42,,210,65,210,145,145,1,144,1,143
71188,Tutin,43,,770,231,770,539,539,4,535,15,520
71188,Tutin,44,,299,25,299,274,274,0,274,11,263
71188,Tutin,45,,365,132,365,233,233,1,232,0,232
71188,Tutin,46,,360,52,360,308,308,2,306,2,304
71188,Tutin,47,,394,297,394,97,97,0,97,2,95
71188,Tutin,48,,565,432,565,133,133,1,132,3,129
71188,Tutin,49,,373,240,373,133,133,0,133,1,132
71188,Tutin,50,,761,463,761,298,298,3,295,7,288
71188,Tutin,51,,605,344,605,261,261,0,261,6,255
71188,Tutin,52,,789,515,789,274,274,1,273,1,272
71188,Tutin,53,,460,333,460,127,127,0,127,11,116
71188,Tutin,54,,173,15,173,158,158,0,158,5,153
71188,Tutin,55,,105,26,105,79,79,0,79,68,11
71188,Tutin,56,,129,28,129,101,101,1,100,2,98
71188,Tutin,57,,112,75,112,37,37,0,37,1,36
71188,Tutin,58,,390,197,390,193,193,0,193,15,178
71188,Tutin,59,,1228,703,1228,525,525,4,521,3,518
71196,Ćićevac,1,,123,68,123,55,55,0,55,29,26
71196,Ćićevac,2,,669,320,669,349,349,15,334,172,162
71196,Ćićevac,3,,398,151,398,247,247,1,246,162,84
71196,Ćićevac,4,,354,142,354,212,212,5,207,148,59
71196,Ćićevac,5,,187,88,187,99,99,4,95,44,51
71196,Ćićevac,6,,500,268,500,232,232,7,225,158,67
71196,Ćićevac,7,,310,158,310,152,152,4,148,105,43
71196,Ćićevac,8,,513,278,513,235,235,3,232,136,96
71196,Ćićevac,9,,562,275,562,287,287,8,279,148,131
71196,Ćićevac,10,,487,224,487,263,263,6,257,156,101
71196,Ćićevac,11,,420,188,420,232,232,2,230,126,104
71196,Ćićevac,12,,100,40,100,60,60,2,58,46,12
71196,Ćićevac,13,,735,330,735,405,405,9,396,239,157
71196,Ćićevac,14,,716,387,716,329,329,5,324,201,123
71196,Ćićevac,15,,710,394,710,316,316,6,310,187,123
71196,Ćićevac,16,,715,274,715,441,441,11,430,231,199
71196,Ćićevac,17,,495,241,495,254,254,2,252,136,116
71196,Ćićevac,18,,484,200,484,284,284,11,273,122,151
71196,Ćićevac,19,,371,185,371,186,186,2,184,93,91
71200,Ćuprija,1,,1184,662,1184,522,521,10,511,218,293
71200,Ćuprija,2,,760,426,760,334,334,3,331,197,134
71200,Ćuprija,3,,1466,784,1466,682,682,9,673,327,346
71200,Ćuprija,4,,1124,547,1124,577,577,9,568,276,292
71200,Ćuprija,5,,1155,583,1155,572,572,16,556,220,336
71200,Ćuprija,6,,1067,501,1067,566,566,7,559,231,328
71200,Ćuprija,7,,1437,750,1437,687,687,10,677,297,380
71200,Ćuprija,8,,558,285,558,273,273,4,269,113,156
71200,Ćuprija,9,,828,462,828,366,365,0,365,183,182
71200,Ćuprija,10,,972,464,972,508,508,17,491,231,260
71200,Ćuprija,11,,1585,843,1586,742,742,12,730,347,383
71200,Ćuprija,12,,1527,763,1528,764,764,13,751,361,390
71200,Ćuprija,13,,1025,530,1025,495,495,7,488,338,150
71200,Ćuprija,14,,1582,836,1582,746,746,15,731,433,298
71200,Ćuprija,15,,668,334,668,334,334,7,327,143,184
71200,Ćuprija,16,,950,470,951,480,480,10,470,207,263
71200,Ćuprija,17,,226,95,226,131,131,1,130,86,44
71200,Ćuprija,18,,1020,832,1020,188,188,1,187,123,64
71200,Ćuprija,19,,819,622,819,197,197,1,196,116,80
71200,Ćuprija,20,,197,161,197,36,36,0,36,26,10
71200,Ćuprija,21,,1007,705,1007,302,302,2,300,225,75
71200,Ćuprija,22,,636,531,636,105,105,2,103,65,38
71200,Ćuprija,23,,224,119,224,105,105,0,105,49,56
71200,Ćuprija,24,,896,718,896,178,178,3,175,119,56
71200,Ćuprija,25,,1186,701,1186,485,485,5,480,287,193
71200,Ćuprija,26,,224,131,224,93,93,12,81,52,29
71200,Ćuprija,27,,1376,928,1376,448,448,3,445,274,171
71200,Ćuprija,28,,1440,803,1440,637,637,5,632,364,268
71200,Ćuprija,29,,565,344,565,221,221,3,218,151,67
71200,Ćuprija,30,,499,299,499,200,200,3,197,133,64
71200,Ćuprija,31,,1283,801,1283,482,482,8,474,270,204
71200,Ćuprija,32,,1425,941,1425,484,484,8,476,357,119
71218,Ub,1,,895,490,895,405,405,2,403,223,180
71218,Ub,2,,184,105,184,79,79,2,77,34,43
71218,Ub,3,,340,96,340,244,244,1,243,205,38
71218,Ub,4,,661,348,661,313,313,5,308,172,136
71218,Ub,5,,112,66,112,46,46,0,46,21,25
71218,Ub,6,,143,56,143,87,87,1,86,37,49
71218,Ub,7,,494,304,494,190,190,1,189,115,74
71218,Ub,8,,410,253,410,157,157,3,154,75,79
71218,Ub,9,,134,35,134,99,99,0,99,49,50
71218,Ub,10,,413,249,413,164,164,3,161,91,70
71218,Ub,11,,251,143,251,108,108,0,108,58,50
71218,Ub,12,,445,272,445,173,173,3,170,95,75
71218,Ub,13,,406,240,406,166,166,1,165,100,65
71218,Ub,14,,537,362,537,175,175,4,171,102,69
71218,Ub,15,,355,208,355,147,147,4,143,81,62
71218,Ub,16,,205,113,205,92,92,1,91,58,33
71218,Ub,17,,300,142,300,158,158,1,157,85,72
71218,Ub,18,,492,249,492,243,243,1,242,129,113
71218,Ub,19,,318,219,318,99,99,1,98,55,43
71218,Ub,20,,299,208,299,91,91,5,86,48,38
71218,Ub,21,,388,200,388,188,188,3,185,114,71
71218,Ub,22,,240,150,240,90,90,2,88,46,42
71218,Ub,23,,410,226,410,184,184,3,181,89,92
71218,Ub,24,,419,210,419,209,209,3,206,138,68
71218,Ub,25,,264,135,264,129,129,1,128,78,50
71218,Ub,26,,561,356,561,205,205,7,198,131,67
71218,Ub,27,,662,416,662,246,246,2,244,150,94
71218,Ub,28,,936,538,936,398,398,10,388,207,181
71218,Ub,29,,220,113,220,107,107,8,99,52,47
71218,Ub,30,,271,118,271,153,153,6,147,54,93
71218,Ub,31,,188,118,188,70,70,1,69,39,30
71218,Ub,32,,419,252,419,167,167,1,166,104,62
71218,Ub,33,,387,209,387,178,178,6,172,80,92
71218,Ub,34,,251,139,251,112,112,2,110,47,63
71218,Ub,35,,162,70,162,92,92,2,90,39,51
71218,Ub,36,,1352,977,1352,375,375,6,369,238,131
71218,Ub,37,,707,423,707,284,284,7,277,129,148
71218,Ub,38,,139,73,139,66,66,2,64,37,27
71218,Ub,39,,196,90,196,106,106,1,105,15,90
71218,Ub,40,,339,187,339,152,152,7,145,80,65
71218,Ub,41,,751,501,751,250,250,0,250,142,108
71218,Ub,42,,666,324,666,342,342,3,339,232,107
71218,Ub,43,,538,240,538,298,298,6,292,95,197
71218,Ub,44,,1023,468,1023,555,555,12,543,217,326
71218,Ub,45,,968,493,968,475,474,3,471,218,253
71218,Ub,46,,1028,514,1028,514,514,9,505,225,280
71218,Ub,47,,1000,491,1000,509,509,5,504,220,284
71218,Ub,48,,507,291,507,216,216,4,212,123,89
71218,Ub,49,,482,446,482,36,36,1,35,13,22
71218,Ub,50,,692,306,692,386,386,7,379,185,194
71218,Ub,51,,262,164,259,98,98,2,96,69,27
71226,Crna Trava,1,,114,81,114,33,33,0,33,25,8
71226,Crna Trava,2,,108,43,108,65,65,0,65,47,18
71226,Crna Trava,3,,295,154,295,141,141,1,140,107,33
71226,Crna Trava,4,,243,151,243,92,92,1,91,81,10
71226,Crna Trava,5,,106,72,106,34,34,2,32,23,9
71226,Crna Trava,6,,133,54,133,79,79,1,78,54,24
71226,Crna Trava,7,,129,65,129,64,64,0,64,52,12
71226,Crna Trava,8,,122,53,122,69,69,1,68,47,21
71226,Crna Trava,9,,158,96,158,62,62,0,62,45,17
71226,Crna Trava,10,,223,75,223,148,148,6,142,100,42
71226,Crna Trava,11,,224,185,224,39,39,1,38,30,8
71226,Crna Trava,12,,526,299,526,227,227,6,221,127,94
71234,Čajetina,1,,228,127,228,101,101,1,100,56,44
71234,Čajetina,2,,224,96,224,128,128,3,125,62,63
71234,Čajetina,3,,339,170,339,169,169,4,165,65,100
71234,Čajetina,4,,198,93,198,105,105,0,105,26,79
71234,Čajetina,5,,369,221,369,148,148,2,146,76,70
71234,Čajetina,6,,355,223,355,132,132,1,131,72,59
71234,Čajetina,7,,551,291,551,260,260,0,260,117,143
71234,Čajetina,8,,213,117,213,96,96,0,96,57,39
71234,Čajetina,9,,353,175,352,178,178,3,175,91,84
71234,Čajetina,10,,138,46,138,92,92,0,92,42,50
71234,Čajetina,11,,259,123,259,136,135,0,135,86,49
71234,Čajetina,12,,199,120,199,79,79,0,79,47,32
71234,Čajetina,13,,298,170,298,128,128,2,126,55,71
71234,Čajetina,14,,737,419,737,318,318,7,311,152,159
71234,Čajetina,15,,140,89,140,51,51,2,49,30,19
71234,Čajetina,16,,246,154,246,92,92,3,89,58,31
71234,Čajetina,17,,180,95,180,85,85,0,85,52,33
71234,Čajetina,18,,636,367,636,269,269,1,268,149,119
71234,Čajetina,19,,118,36,118,82,82,2,80,59,21
71234,Čajetina,20,,131,63,131,68,68,1,67,49,18
71234,Čajetina,21,,221,105,221,116,116,0,116,48,68
71234,Čajetina,22,,825,396,825,429,427,1,426,207,219
71234,Čajetina,23,,291,182,291,109,109,1,108,66,42
71234,Čajetina,24,,219,109,219,110,110,2,108,50,58
71234,Čajetina,25,,520,209,520,311,311,10,301,121,180
71234,Čajetina,26,,2198,1128,2198,1070,1070,21,1049,447,602
71234,Čajetina,27,,2475,1307,2475,1168,1168,32,1136,474,662
71242,Čačak,1,,2086,1049,2086,1037,1036,26,1010,339,671
71242,Čačak,2,,789,389,789,400,400,8,392,152,240
71242,Čačak,3,,1215,639,1215,576,576,15,561,251,310
71242,Čačak,4,,1923,940,1923,983,983,7,976,366,610
71242,Čačak,5,,1763,844,1764,919,918,12,906,273,633
71242,Čačak,6,,1652,786,1652,866,866,14,852,296,556
71242,Čačak,7,,1469,660,1469,809,809,22,787,234,553
71242,Čačak,8,,1362,654,1362,708,708,5,703,204,499
71242,Čačak,9,,1105,567,1106,538,538,6,532,177,355
71242,Čačak,10,,1372,621,1372,751,751,15,736,204,532
71242,Čačak,11,,959,506,959,453,453,4,449,141,308
71242,Čačak,12,,1658,814,1658,844,844,13,831,280,551
71242,Čačak,13,,1612,790,1612,822,822,6,816,311,505
71242,Čačak,14,,1757,893,1757,864,864,22,842,302,540
71242,Čačak,15,,2248,1230,2248,1018,1018,12,1006,378,628
71242,Čačak,16,,1857,953,1857,904,904,10,894,267,627
71242,Čačak,17,,2232,1212,2232,1020,1020,10,1010,384,626
71242,Čačak,18,,1807,888,1807,919,919,17,902,353,549
71242,Čačak,19,,1653,745,1653,908,906,24,882,241,641
71242,Čačak,20,,1426,558,1426,868,868,12,856,227,629
71242,Čačak,21,,1181,569,1181,612,612,12,600,185,415
71242,Čačak,22,,1087,472,1087,615,615,3,612,235,377
71242,Čačak,23,,1157,604,1157,553,553,7,546,138,408
71242,Čačak,24,,1260,706,1260,554,554,8,546,162,384
71242,Čačak,25,,1511,860,1512,651,651,11,640,237,403
71242,Čačak,26,,1396,743,1396,653,653,9,644,267,377
71242,Čačak,27,,1383,644,1383,739,739,17,722,242,480
71242,Čačak,28,,1164,613,1164,551,549,17,532,184,348
71242,Čačak,29,,1837,915,1837,922,922,13,909,308,601
71242,Čačak,30,,1340,733,1341,607,607,9,598,273,325
71242,Čačak,31,,1845,915,1845,930,930,11,919,329,590
71242,Čačak,32,,238,138,238,100,100,1,99,53,46
71242,Čačak,33,,265,127,265,138,138,3,135,71,64
71242,Čačak,34,,124,82,124,42,42,0,42,30,12
71242,Čačak,35,,167,125,167,42,42,0,42,18,24
71242,Čačak,36,,921,612,921,309,309,6,303,107,196
71242,Čačak,37,,1158,738,1158,420,420,7,413,164,249
71242,Čačak,38,,797,455,797,342,342,1,341,172,169
71242,Čačak,39,,1276,716,1276,560,560,3,557,229,328
71242,Čačak,40,,129,74,129,55,55,1,54,15,39
71242,Čačak,41,,612,330,612,282,282,7,275,80,195
71242,Čačak,42,,152,67,152,85,85,1,84,17,67
71242,Čačak,43,,398,237,398,161,161,0,161,71,90
71242,Čačak,44,,1285,723,1285,562,562,3,559,256,303
71242,Čačak,45,,1125,714,1126,411,411,6,405,200,205
71242,Čačak,46,,1279,630,1279,649,649,9,640,262,378
71242,Čačak,47,,1868,1011,1868,857,857,13,844,414,430
71242,Čačak,48,,1568,874,1568,694,692,11,681,290,391
71242,Čačak,49,,1481,836,1481,645,645,4,641,296,345
71242,Čačak,50,,1758,886,1758,872,872,12,860,303,557
71242,Čačak,51,,1791,902,1792,889,889,13,876,426,450
71242,Čačak,52,,1192,681,1192,511,511,4,507,240,267
71242,Čačak,53,,822,529,822,293,293,5,288,101,187
71242,Čačak,54,,536,285,536,251,251,3,248,105,143
71242,Čačak,55,,365,178,365,187,187,2,185,74,111
71242,Čačak,56,,278,142,278,136,136,4,132,62,70
71242,Čačak,57,,715,430,715,285,285,10,275,138,137
71242,Čačak,58,,372,225,372,147,147,0,147,53,94
71242,Čačak,59,,259,164,259,95,95,0,95,32,63
71242,Čačak,60,,255,131,255,124,124,1,123,27,96
71242,Čačak,61,,282,139,282,143,143,6,137,48,89
71242,Čačak,62,,403,247,403,156,156,4,152,75,77
71242,Čačak,63,,117,54,117,63,63,0,63,23,40
71242,Čačak,64,,359,188,359,171,171,1,170,74,96
71242,Čačak,65,,283,154,283,129,129,2,127,49,78
71242,Čačak,66,,209,110,209,99,99,0,99,14,85
71242,Čačak,67,,763,426,763,337,337,4,333,147,186
71242,Čačak,68,,1106,693,1106,413,413,6,407,197,210
71242,Čačak,69,,1171,587,1171,584,584,6,578,271,307
71242,Čačak,70,,799,516,799,283,283,1,282,145,137
71242,Čačak,71,,772,446,772,326,326,9,317,190,127
71242,Čačak,72,,597,308,597,289,289,4,285,157,128
71242,Čačak,73,,486,284,486,202,202,0,202,99,103
71242,Čačak,74,,524,300,524,224,224,2,222,140,82
71242,Čačak,75,,314,154,314,160,160,0,160,76,84
71242,Čačak,76,,263,138,263,125,125,1,124,67,57
71242,Čačak,77,,215,117,215,98,98,2,96,42,54
71242,Čačak,78,,109,37,109,72,72,2,70,39,31
71242,Čačak,79,,527,317,527,210,210,1,209,72,137
71242,Čačak,80,,302,200,302,102,102,2,100,41,59
71242,Čačak,81,,1090,677,1090,413,413,3,410,189,221
71242,Čačak,82,,471,264,471,207,207,5,202,101,101
71242,Čačak,83,,996,542,996,454,454,8,446,176,270
71242,Čačak,84,,543,271,542,272,272,5,267,152,115
71242,Čačak,85,,279,171,279,108,108,0,108,56,52
71242,Čačak,86,,800,434,800,366,366,5,361,153,208
71242,Čačak,87,,322,202,322,120,120,1,119,64,55
71242,Čačak,88,,779,429,779,350,350,3,347,148,199
71242,Čačak,89,,581,344,581,237,237,2,235,113,122
71242,Čačak,90,,1100,668,1100,432,432,9,423,194,229
71242,Čačak,91,,1119,667,1119,452,452,7,445,203,242
71242,Čačak,92,,1540,838,1541,702,702,8,694,314,380
71242,Čačak,93,,1734,1011,1734,723,723,14,709,322,387
71242,Čačak,94,,1812,1105,1812,707,707,17,690,299,391
71242,Čačak,95,,459,263,459,196,196,4,192,66,126
71242,Čačak,96,,1547,826,1547,721,721,12,709,351,358
71242,Čačak,97,,602,367,602,235,235,2,233,81,152
71242,Čačak,98,,339,176,339,163,163,0,163,60,103
71242,Čačak,99,,931,556,931,375,375,10,365,143,222
71242,Čačak,100,,630,270,630,360,360,2,358,159,199
71242,Čačak,101,,203,113,203,90,90,0,90,40,50
71242,Čačak,102,,417,241,417,176,176,2,174,71,103
71242,Čačak,103,,304,189,304,115,115,2,113,48,65
71269,Šabac,1,,1550,692,1553,858,856,18,838,301,537
71269,Šabac,2,,1574,756,1576,818,817,24,793,301,492
71269,Šabac,3,,1375,564,1375,811,810,20,790,269,521
71269,Šabac,4,,1398,581,1399,817,817,14,803,316,487
71269,Šabac,5,,1624,699,1624,925,925,19,906,308,598
71269,Šabac,6,,1278,572,1278,706,705,13,692,253,439
71269,Šabac,7,,1368,616,1368,752,752,9,743,274,469
71269,Šabac,8,,1842,938,1848,904,904,17,887,419,468
71269,Šabac,9,,1593,731,1593,862,862,22,840,437,403
71269,Šabac,10,,1259,586,1259,673,672,14,658,263,395
71269,Šabac,11,,1370,599,1370,771,769,17,752,250,502
71269,Šabac,12,,1697,802,1700,895,894,22,872,313,559
71269,Šabac,13,,1262,588,1262,674,673,16,657,211,446
71269,Šabac,14,,1286,584,1287,702,702,20,682,255,427
71269,Šabac,15,,1178,538,1180,640,640,14,626,216,410
71269,Šabac,16,,1581,704,1582,877,877,15,862,319,543
71269,Šabac,17,,1686,734,1689,952,952,18,934,356,578
71269,Šabac,18,,1604,710,1606,894,894,14,880,346,534
71269,Šabac,19,,1470,679,1471,791,791,17,774,335,439
71269,Šabac,20,,1606,755,1610,851,851,17,834,289,545
71269,Šabac,21,,1263,560,1264,703,702,11,691,278,413
71269,Šabac,22,,1396,625,1398,771,771,12,759,310,449
71269,Šabac,23,,1193,581,1194,612,612,12,600,289,311
71269,Šabac,24,,1589,772,1591,817,817,13,804,391,413
71269,Šabac,25,,2113,1083,2113,1030,1030,32,998,575,423
71269,Šabac,26,,2075,984,2080,1091,1091,27,1064,515,549
71269,Šabac,27,,1185,599,1187,586,586,20,566,281,285
71269,Šabac,28,,1546,719,1546,827,827,12,815,415,400
71269,Šabac,29,,1203,566,1203,637,636,11,625,262,363
71269,Šabac,30,,1794,1011,1795,783,783,15,768,483,285
71269,Šabac,31,,1806,910,1806,896,896,13,883,524,359
71269,Šabac,32,,2158,1100,2158,1058,1058,25,1033,604,429
71269,Šabac,33,,1076,610,1076,466,466,7,459,224,235
71269,Šabac,34,,1604,1051,1604,553,553,7,546,362,184
71269,Šabac,35,,974,542,974,432,432,9,423,187,236
71269,Šabac,36,,901,570,901,331,331,5,326,151,175
71269,Šabac,37,,941,519,942,422,422,6,416,218,198
71269,Šabac,38,,1269,694,1296,575,574,9,565,362,203
71269,Šabac,39,,1569,827,1569,742,742,14,728,413,315
71269,Šabac,40,,1188,705,1190,483,483,8,475,282,193
71269,Šabac,41,,1416,782,1416,634,634,7,627,399,228
71269,Šabac,42,,1579,768,1579,811,811,12,799,415,384
71269,Šabac,43,,1264,686,1264,578,578,9,569,270,299
71269,Šabac,44,,1155,588,1157,567,567,5,562,279,283
71269,Šabac,45,,1106,549,1106,557,557,14,543,310,233
71269,Šabac,46,,314,104,314,210,210,4,206,100,106
71269,Šabac,47,,1413,849,1413,564,564,15,549,312,237
71269,Šabac,48,,847,514,847,333,333,4,329,152,177
71269,Šabac,49,,266,170,266,96,96,2,94,64,30
71269,Šabac,50,,1168,574,1168,594,593,9,584,343,241
71269,Šabac,51,,1128,518,1128,610,610,15,595,267,328
71269,Šabac,52,,1334,727,1334,607,607,8,599,346,253
71269,Šabac,53,,551,300,551,251,251,1,250,138,112
71269,Šabac,54,,709,455,709,254,254,7,247,113,134
71269,Šabac,55,,1028,545,1028,483,483,2,481,240,241
71269,Šabac,56,,349,201,349,148,148,0,148,82,66
71269,Šabac,57,,753,487,753,266,266,3,263,122,141
71269,Šabac,58,,905,524,905,381,381,6,375,258,117
71269,Šabac,59,,917,537,917,380,380,6,374,190,184
71269,Šabac,60,,563,253,563,310,310,3,307,173,134
71269,Šabac,61,,193,112,193,81,81,0,81,54,27
71269,Šabac,62,,997,470,997,527,527,11,516,293,223
71269,Šabac,63,,538,293,538,245,245,2,243,186,57
71269,Šabac,64,,641,370,641,271,271,6,265,164,101
71269,Šabac,65,,1540,820,1540,720,718,7,711,447,264
71269,Šabac,66,,216,71,216,145,145,3,142,96,46
71269,Šabac,67,,311,137,311,174,174,1,173,102,71
71269,Šabac,68,,526,323,526,203,203,2,201,99,102
71269,Šabac,69,,313,162,313,151,151,2,149,74,75
71269,Šabac,70,,330,176,330,154,154,2,152,87,65
71269,Šabac,71,,271,173,271,98,98,3,95,57,38
71269,Šabac,72,,373,209,373,164,164,2,162,93,69
71269,Šabac,73,,530,296,534,234,234,4,230,173,57
71269,Šabac,74,,1508,839,1508,669,668,5,663,408,255
71269,Šabac,75,,1074,583,1074,491,491,11,480,269,211
71269,Šabac,76,,1140,590,1140,550,550,7,543,351,192
71269,Šabac,77,,137,82,137,55,55,2,53,32,21
71269,Šabac,78,,529,288,529,241,241,5,236,126,110
71269,Šabac,79,,382,171,382,211,211,9,202,119,83
71269,Šabac,80,,264,127,264,137,137,1,136,90,46
71269,Šabac,81,,197,62,198,135,135,2,133,58,75
71269,Šabac,82,,679,343,679,336,336,2,334,163,171
71269,Šabac,83,,324,99,324,225,225,1,224,100,124
71269,Šabac,84,,1547,819,1550,728,727,6,721,402,319
71269,Šabac,85,,1354,849,1354,505,504,7,497,310,187
71269,Šabac,86,,1207,689,1209,518,518,9,509,327,182
71269,Šabac,87,,564,340,565,224,224,3,221,124,97
71269,Šabac,88,,358,167,358,191,191,2,189,80,109
71269,Šabac,89,,485,281,485,204,204,4,200,101,99
71269,Šabac,90,,254,133,254,121,121,3,118,84,34
71269,Šabac,91,,217,114,217,103,103,4,99,78,21
71269,Šabac,92,,304,177,304,127,127,5,122,74,48
71269,Šabac,93,,285,168,285,117,117,2,115,63,52
71269,Šabac,94,,216,106,216,110,110,1,109,65,44
71269,Šabac,95,,284,143,284,141,141,2,139,89,50
71269,Šabac,96,,204,98,204,106,106,0,106,79,27
71269,Šabac,97,,393,181,393,212,212,1,211,102,109
71269,Šabac,98,,420,231,420,189,189,1,188,146,42
71269,Šabac,99,,380,210,380,170,170,0,170,145,25
71269,Šabac,100,,361,205,361,156,156,3,153,79,74
71269,Šabac,101,,335,151,335,184,184,2,182,114,68
71269,Šabac,102,,317,93,317,224,224,6,218,133,85
71269,Šabac,103,,375,192,375,183,183,3,180,81,99
71277,Lapovo,1,,533,248,533,285,285,4,281,138,143
71277,Lapovo,2,,576,274,576,302,302,7,295,143,152
71277,Lapovo,3,,763,402,763,361,361,9,352,175,177
71277,Lapovo,4,,770,445,770,325,325,4,321,191,130
71277,Lapovo,5,,801,399,801,402,402,13,389,196,193
71277,Lapovo,6,,699,336,699,363,363,5,358,176,182
71277,Lapovo,7,,708,360,708,348,348,7,341,206,135
71277,Lapovo,8,,757,353,757,404,404,7,397,211,186
71277,Lapovo,9,,672,311,672,361,361,7,354,222,132
71277,Lapovo,10,,660,317,660,343,343,5,338,179,159
71277,Lapovo,11,,636,293,636,343,343,9,334,143,191
71285,Niška Banja,1,,1904,1044,1904,860,860,19,841,356,485
71285,Niška Banja,2,,2017,1145,2017,872,872,10,862,455,407
71285,Niška Banja,3,,902,498,902,404,404,5,399,228,171
71285,Niška Banja,4,,137,86,137,51,51,1,50,34,16
71285,Niška Banja,5,,1815,1090,1815,725,725,12,713,424,289
71285,Niška Banja,6,,1731,1067,1731,664,663,11,652,362,290
71285,Niška Banja,7,,735,469,735,266,266,2,264,134,130
71285,Niška Banja,8,,516,263,516,253,253,3,250,110,140
71285,Niška Banja,9,,709,526,709,183,183,2,181,140,41
71285,Niška Banja,10,,197,165,197,32,32,2,30,18,12
71285,Niška Banja,11,,1390,834,1390,556,556,14,542,316,226
71285,Niška Banja,12,,237,116,237,121,121,3,118,75,43
71285,Niška Banja,13,,302,129,302,173,173,8,165,96,69
71285,Niška Banja,14,,334,160,334,174,174,4,170,106,64
80012,Ada,1,,822,409,822,413,413,1,412,52,360
80012,Ada,2,,449,158,450,291,290,1,289,72,217
80012,Ada,3,,457,197,457,260,260,0,260,74,186
80012,Ada,4,,692,290,692,402,402,3,399,13,386
80012,Ada,5,,649,272,650,377,376,1,375,16,359
80012,Ada,6,,709,267,709,442,440,2,438,13,425
80012,Ada,7,,810,369,811,441,440,3,437,74,363
80012,Ada,8,,721,301,721,420,420,3,417,16,401
80012,Ada,9,,547,244,547,303,303,3,300,12,288
80012,Ada,10,,603,281,603,322,322,2,320,10,310
80012,Ada,11,,767,338,767,429,429,3,426,19,407
80012,Ada,12,,611,262,611,349,349,0,349,20,329
80012,Ada,13,,480,239,480,241,241,1,240,13,227
80012,Ada,14,,499,199,499,300,300,1,299,6,293
80012,Ada,15,,870,342,870,528,528,1,527,12,515
80012,Ada,16,,590,340,590,250,250,4,246,134,112
80012,Ada,17,,485,224,485,261,261,3,258,134,124
80012,Ada,18,,716,298,716,418,418,3,415,225,190
80012,Ada,19,,622,316,623,306,306,2,304,137,167
80012,Ada,20,,785,327,786,458,458,0,458,12,446
80012,Ada,21,,660,272,660,388,388,0,388,13,375
80012,Ada,22,,435,180,435,255,255,1,254,4,250
80012,Ada,23,,441,197,441,244,244,3,241,14,227
80012,Ada,24,,419,168,419,251,251,2,249,3,246
80012,Ada,25,,474,237,474,237,237,3,234,9,225
80012,Ada,26,,310,144,310,166,166,4,162,5,157
80012,Ada,27,,195,126,195,69,69,0,69,4,65
80012,Ada,28,,456,216,456,240,240,5,235,3,232
80012,Ada,29,,365,183,365,182,182,0,182,6,176
80039,Alibunar,1,,760,397,760,363,363,4,359,170,189
80039,Alibunar,2,,754,408,752,346,346,4,342,180,162
80039,Alibunar,3,,601,310,601,291,290,3,287,104,183
80039,Alibunar,4,,659,383,659,276,276,8,268,110,158
80039,Alibunar,5,,836,425,836,411,411,5,406,261,145
80039,Alibunar,6,,1060,590,1061,470,470,3,467,257,210
80039,Alibunar,7,,751,405,751,346,345,2,343,190,153
80039,Alibunar,8,,1336,720,1336,616,616,8,608,306,302
80039,Alibunar,9,,695,405,695,290,290,5,285,155,130
80039,Alibunar,10,,722,454,722,268,268,4,264,124,140
80039,Alibunar,11,,637,397,637,240,240,1,239,87,152
80039,Alibunar,12,,611,401,611,210,210,2,208,54,154
80039,Alibunar,13,,739,463,739,276,276,1,275,151,124
80039,Alibunar,14,,609,351,609,258,258,1,257,164,93
80039,Alibunar,15,,1122,728,1122,394,394,3,391,209,182
80039,Alibunar,16,,741,418,741,323,323,4,319,178,141
80039,Alibunar,17,,703,380,703,323,323,6,317,171,146
80039,Alibunar,18,,1050,689,1050,361,361,7,354,76,278
80039,Alibunar,19,,1156,759,1156,397,397,6,391,12,379
80039,Alibunar,20,,1029,651,1029,378,378,10,368,8,360
80039,Alibunar,21,,1173,793,1173,380,380,7,373,83,290
80039,Alibunar,22,,655,321,655,334,334,6,328,162,166
80039,Alibunar,23,,1060,619,1060,441,441,4,437,135,302
80039,Alibunar,24,,156,98,156,58,58,0,58,44,14
80047,Apatin,1,,869,350,869,519,519,8,511,273,238
80047,Apatin,2,,875,426,875,449,449,5,444,249,195
80047,Apatin,3,,888,474,888,414,414,4,410,239,171
80047,Apatin,4,,862,388,862,474,474,8,466,269,197
80047,Apatin,5,,827,424,827,403,403,4,399,247,152
80047,Apatin,6,,848,381,848,467,466,5,461,205,256
80047,Apatin,7,,936,484,936,452,452,1,451,226,225
80047,Apatin,8,,944,505,944,439,439,7,432,216,216
80047,Apatin,9,,1214,597,1214,617,617,8,609,273,336
80047,Apatin,10,,865,464,866,401,401,3,398,216,182
80047,Apatin,11,,977,479,977,498,498,2,496,251,245
80047,Apatin,12,,888,393,888,495,495,4,491,293,198
80047,Apatin,13,,893,414,893,479,479,2,477,329,148
80047,Apatin,14,,849,408,849,441,441,2,439,236,203
80047,Apatin,15,,939,509,939,430,430,6,424,264,160
80047,Apatin,16,,856,472,856,384,384,2,382,253,129
80047,Apatin,17,,1245,1044,1245,201,201,2,199,130,69
80047,Apatin,18,,870,541,870,329,329,7,322,59,263
80047,Apatin,19,,866,502,866,364,364,6,358,50,308
80047,Apatin,20,,869,467,869,402,402,5,397,52,345
80047,Apatin,21,,846,419,846,427,427,11,416,52,364
80047,Apatin,22,,871,478,871,393,393,5,388,96,292
80047,Apatin,23,,956,428,956,528,528,4,524,393,131
80047,Apatin,24,,935,443,935,492,492,4,488,395,93
80047,Apatin,25,,929,524,929,405,405,1,404,311,93
80047,Apatin,26,,946,523,946,423,423,8,415,325,90
80047,Apatin,27,,938,430,938,508,507,4,503,39,464
80047,Apatin,28,,924,431,924,493,493,3,490,25,465
80047,Apatin,29,,1104,549,1104,555,555,5,550,134,416
80055,Bač,1,,688,289,688,399,399,6,393,299,94
80055,Bač,2,,603,225,603,378,378,6,372,127,245
80055,Bač,3,,481,150,481,331,331,11,320,181,139
80055,Bač,4,,443,128,443,315,315,3,312,124,188
80055,Bač,5,,566,164,566,402,402,8,394,207,187
80055,Bač,6,,497,148,497,349,349,7,342,144,198
80055,Bač,7,,577,192,577,385,385,7,378,239,139
80055,Bač,8,,562,183,563,379,379,7,372,214,158
80055,Bač,9,,597,207,597,390,390,2,388,255,133
80055,Bač,10,,486,192,486,294,294,2,292,133,159
80055,Bač,11,,595,278,595,317,317,3,314,154,160
80055,Bač,12,,420,162,420,258,258,1,257,106,151
80055,Bač,13,,518,197,518,321,321,3,318,165,153
80055,Bač,14,,479,148,480,331,331,1,330,175,155
80055,Bač,15,,548,336,549,212,212,3,209,94,115
80055,Bač,16,,496,221,496,275,275,5,270,109,161
80055,Bač,17,,414,122,414,292,292,3,289,157,132
80055,Bač,18,,339,124,339,215,215,2,213,105,108
80055,Bač,19,,110,18,110,92,92,3,89,47,42
80055,Bač,20,,529,167,529,362,362,6,356,138,218
80055,Bač,21,,571,156,571,415,415,9,406,172,234
80055,Bač,22,,535,209,535,326,326,4,322,45,277
80055,Bač,23,,527,232,527,295,295,4,291,62,229
80055,Bač,24,,575,209,575,366,366,4,362,52,310
80055,Bač,25,,611,289,611,322,322,4,318,57,261
80055,Bač,26,,550,237,550,313,313,6,307,35,272
80063,Bačka Palanka,1,,1096,495,1096,601,601,5,596,404,192
80063,Bačka Palanka,2,,1293,530,1293,763,763,6,757,499,258
80063,Bačka Palanka,3,,1330,568,1330,762,762,16,746,500,246
80063,Bačka Palanka,4,,1408,613,1408,795,795,8,787,499,288
80063,Bačka Palanka,5,,1383,594,1384,789,788,12,776,485,291
80063,Bačka Palanka,6,,792,374,792,418,418,4,414,213,201
80063,Bačka Palanka,7,,1245,458,1245,787,787,9,778,367,411
80063,Bačka Palanka,8,,1138,463,1138,675,675,9,666,274,392
80063,Bačka Palanka,9,,1093,449,1093,644,644,8,636,310,326
80063,Bačka Palanka,10,,1498,657,1498,841,841,7,834,439,395
80063,Bačka Palanka,11,,1154,469,1154,685,685,12,673,418,255
80063,Bačka Palanka,12,,1124,432,1124,692,692,7,685,389,296
80063,Bačka Palanka,13,,1149,498,1149,651,650,13,637,348,289
80063,Bačka Palanka,14,,979,431,979,548,548,11,537,350,187
80063,Bačka Palanka,15,,1175,555,1175,620,620,8,612,344,268
80063,Bačka Palanka,16,,1050,397,1050,653,653,6,647,309,338
80063,Bačka Palanka,17,,1438,648,1439,790,790,7,783,474,309
80063,Bačka Palanka,18,,980,432,980,548,548,4,544,312,232
80063,Bačka Palanka,19,,1418,687,1418,731,731,13,718,495,223
80063,Bačka Palanka,20,,1207,525,1207,682,682,10,672,428,244
80063,Bačka Palanka,21,,934,472,934,462,462,9,453,261,192
80063,Bačka Palanka,22,,884,478,884,406,406,3,403,243,160
80063,Bačka Palanka,23,,1179,551,1179,628,628,10,618,403,215
80063,Bačka Palanka,24,,750,378,750,372,372,5,367,217,150
80063,Bačka Palanka,25,,284,146,284,138,138,0,138,81,57
80063,Bačka Palanka,26,,1044,441,1044,603,603,9,594,426,168
80063,Bačka Palanka,27,,1103,499,1103,604,604,3,601,430,171
80063,Bačka Palanka,28,,1259,518,1259,741,741,4,737,554,183
80063,Bačka Palanka,29,,977,435,977,542,542,3,539,293,246
80063,Bačka Palanka,30,,1118,455,1118,663,663,6,657,387,270
80063,Bačka Palanka,31,,784,361,784,423,423,10,413,260,153
80063,Bačka Palanka,32,,1530,640,1530,890,890,9,881,612,269
80063,Bačka Palanka,33,,1077,491,1077,586,586,8,578,192,386
80063,Bačka Palanka,34,,812,362,812,450,450,6,444,99,345
80063,Bačka Palanka,35,,1225,558,1225,667,667,5,662,46,616
80063,Bačka Palanka,36,,785,347,785,438,438,10,428,317,111
80063,Bačka Palanka,37,,185,76,185,109,109,2,107,70,37
80063,Bačka Palanka,38,,1322,516,1322,806,804,7,797,560,237
80063,Bačka Palanka,39,,1330,528,1330,802,802,7,795,549,246
80063,Bačka Palanka,40,,1205,498,1205,707,707,4,703,482,221
80063,Bačka Palanka,41,,1296,611,1295,685,685,6,679,485,194
80063,Bačka Palanka,42,,1140,484,1141,656,656,9,647,395,252
80063,Bačka Palanka,43,,1150,556,1150,594,594,11,583,427,156
80071,Bačka Topola,1,,746,325,746,421,421,2,419,122,297
80071,Bačka Topola,2,,824,341,824,483,483,1,482,62,420
80071,Bačka Topola,3,,711,271,711,440,440,1,439,61,378
80071,Bačka Topola,4,,745,279,745,466,466,4,462,52,410
80071,Bačka Topola,5,,713,276,713,437,437,8,429,46,383
80071,Bačka Topola,6,,747,270,747,477,477,3,474,85,389
80071,Bačka Topola,7,,754,333,754,421,421,4,417,57,360
80071,Bačka Topola,8,,776,342,776,434,434,3,431,81,350
80071,Bačka Topola,9,,679,340,679,339,339,6,333,136,197
80071,Bačka Topola,10,,634,210,634,424,424,8,416,67,349
80071,Bačka Topola,11,,801,370,801,431,431,0,431,76,355
80071,Bačka Topola,12,,882,359,882,523,521,5,516,148,368
80071,Bačka Topola,13,,790,379,790,411,411,5,406,98,308
80071,Bačka Topola,14,,747,305,747,442,442,1,441,84,357
80071,Bačka Topola,15,,683,310,683,373,373,11,362,174,188
80071,Bačka Topola,16,,692,289,692,403,403,3,400,66,334
80071,Bačka Topola,17,,704,304,704,400,400,3,397,53,344
80071,Bačka Topola,18,,690,307,690,383,383,4,379,33,346
80071,Bačka Topola,19,,668,291,668,377,377,3,374,44,330
80071,Bačka Topola,20,,382,134,382,248,248,1,247,159,88
80071,Bačka Topola,21,,1084,488,1084,596,596,6,590,76,514
80071,Bačka Topola,22,,976,428,976,548,548,8,540,85,455
80071,Bačka Topola,23,,681,310,681,371,371,5,366,230,136
80071,Bačka Topola,24,,120,49,120,71,71,0,71,60,11
80071,Bačka Topola,25,,415,174,415,241,241,1,240,164,76
80071,Bačka Topola,26,,414,190,414,224,224,3,221,177,44
80071,Bačka Topola,27,,678,307,678,371,371,2,369,203,166
80071,Bačka Topola,28,,515,203,515,312,312,2,310,222,88
80071,Bačka Topola,29,,593,268,593,325,325,0,325,3,322
80071,Bačka Topola,30,,166,74,166,92,92,1,91,8,83
80071,Bačka Topola,31,,646,341,646,305,305,1,304,14,290
80071,Bačka Topola,32,,274,97,274,177,177,1,176,58,118
80071,Bačka Topola,33,,195,58,195,137,137,1,136,1,135
80071,Bačka Topola,34,,175,48,175,127,127,1,126,72,54
80071,Bačka Topola,35,,479,200,479,279,279,1,278,213,65
80071,Bačka Topola,36,,786,367,786,419,419,2,417,96,321
80071,Bačka Topola,37,,867,423,867,444,444,6,438,145,293
80071,Bačka Topola,38,,771,363,771,408,408,5,403,23,380
80071,Bačka Topola,39,,806,324,806,482,482,5,477,14,463
80071,Bačka Topola,40,,752,331,752,421,421,5,416,20,396
80071,Bačka Topola,41,,763,372,763,391,391,3,388,15,373
80071,Bačka Topola,42,,852,377,852,475,475,2,473,18,455
80071,Bačka Topola,43,,747,342,747,405,405,1,404,26,378
80071,Bačka Topola,44,,724,333,724,391,391,3,388,14,374
80071,Bačka Topola,45,,892,395,892,497,497,4,493,28,465
80071,Bačka Topola,46,,792,340,792,452,452,5,447,43,404
80071,Bačka Topola,47,,429,177,429,252,252,2,250,206,44
80071,Bačka Topola,48,,441,216,441,225,225,3,222,128,94
80071,Bačka Topola,49,,239,108,239,131,131,3,128,44,84
80080,Bački Petrovac,1,,346,128,346,218,218,0,218,23,195
80080,Bački Petrovac,2,,379,165,379,214,214,2,212,16,196
80080,Bački Petrovac,3,,378,168,378,210,210,1,209,12,197
80080,Bački Petrovac,4,,372,180,372,192,192,3,189,28,161
80080,Bački Petrovac,5,,330,154,330,176,176,0,176,32,144
80080,Bački Petrovac,6,,370,163,370,207,207,2,205,18,187
80080,Bački Petrovac,7,,416,194,416,222,222,2,220,21,199
80080,Bački Petrovac,8,,331,138,331,193,193,1,192,21,171
80080,Bački Petrovac,9,,411,156,411,255,255,1,254,27,227
80080,Bački Petrovac,10,,361,156,361,205,205,0,205,21,184
80080,Bački Petrovac,11,,470,179,470,291,291,1,290,20,270
80080,Bački Petrovac,12,,306,116,306,190,190,3,187,22,165
80080,Bački Petrovac,13,,421,195,421,226,226,1,225,18,207
80080,Bački Petrovac,14,,513,193,513,320,320,1,319,19,300
80080,Bački Petrovac,15,,414,210,414,204,204,0,204,19,185
80080,Bački Petrovac,16,,466,164,466,302,302,3,299,16,283
80080,Bački Petrovac,17,,333,143,333,190,190,2,188,10,178
80080,Bački Petrovac,18,,332,168,332,164,164,1,163,14,149
80080,Bački Petrovac,19,,360,157,360,203,203,4,199,11,188
80080,Bački Petrovac,20,,305,143,305,162,162,2,160,10,150
80080,Bački Petrovac,21,,414,207,414,207,207,1,206,42,164
80080,Bački Petrovac,22,,430,199,430,231,231,2,229,30,199
80080,Bački Petrovac,23,,320,149,320,171,171,0,171,24,147
80080,Bački Petrovac,24,,357,158,357,199,199,2,197,51,146
80080,Bački Petrovac,25,,375,173,375,202,202,1,201,55,146
80080,Bački Petrovac,26,,439,188,439,251,251,3,248,55,193
80080,Bački Petrovac,27,,515,248,515,267,267,3,264,190,74
80080,Bački Petrovac,28,,435,234,435,201,201,4,197,131,66
80080,Bački Petrovac,29,,398,196,398,202,202,2,200,126,74
80080,Bački Petrovac,30,,383,151,383,232,232,0,232,167,65
80080,Bački Petrovac,31,,400,186,401,214,214,4,210,155,55
80098,Bela Crkva,1,,1297,590,1297,707,707,12,695,334,361
80098,Bela Crkva,2,,1123,530,1123,593,593,8,585,316,269
80098,Bela Crkva,3,,1260,600,1260,660,660,6,654,310,344
80098,Bela Crkva,4,,1323,625,1324,698,696,14,682,308,374
80098,Bela Crkva,5,,803,410,803,393,393,4,389,192,197
80098,Bela Crkva,6,,963,494,963,469,469,9,460,244,216
80098,Bela Crkva,7,,1172,626,1172,546,545,9,536,257,279
80098,Bela Crkva,8,,1145,722,1145,423,423,3,420,230,190
80098,Bela Crkva,9,,717,425,717,292,292,2,290,205,85
80098,Bela Crkva,10,,174,85,174,89,89,0,89,52,37
80098,Bela Crkva,11,,1305,778,1305,527,527,17,510,299,211
80098,Bela Crkva,12,,1068,672,1068,396,396,9,387,43,344
80098,Bela Crkva,13,,178,57,178,121,121,0,121,17,104
80098,Bela Crkva,14,,728,448,728,280,280,1,279,175,104
80098,Bela Crkva,15,,1263,771,1263,492,492,4,488,309,179
80098,Bela Crkva,16,,235,140,235,95,95,0,95,61,34
80098,Bela Crkva,17,,102,41,102,61,61,4,57,43,14
80098,Bela Crkva,18,,836,405,836,431,431,18,413,229,184
80098,Bela Crkva,19,,1097,561,1097,536,536,8,528,333,195
80098,Bela Crkva,20,,585,294,585,291,291,2,289,172,117
80101,Beočin,1,,127,69,127,58,58,2,56,48,8
80101,Beočin,2,,907,641,909,266,266,7,259,134,125
80101,Beočin,3,,709,402,709,307,307,3,304,202,102
80101,Beočin,4,,1523,714,1522,809,808,12,796,420,376
80101,Beočin,5,,1251,597,1251,654,654,10,644,339,305
80101,Beočin,6,,821,378,821,443,443,4,439,260,179
80101,Beočin,7,,1053,524,1053,529,529,2,527,333,194
80101,Beočin,8,,814,358,814,456,456,5,451,318,133
80101,Beočin,9,,625,286,625,339,339,5,334,225,109
80101,Beočin,10,,385,189,385,196,196,3,193,129,64
80101,Beočin,11,,222,112,222,110,110,0,110,82,28
80101,Beočin,12,,657,327,657,330,330,6,324,195,129
80101,Beočin,13,,803,409,803,394,394,4,390,236,154
80101,Beočin,14,,527,222,527,305,305,2,303,203,100
80101,Beočin,15,,835,441,835,394,394,4,390,263,127
80101,Beočin,16,,619,383,619,236,236,3,233,27,206
80101,Beočin,17,,250,146,250,104,104,3,101,72,29
80101,Beočin,18,,104,36,104,68,68,2,66,56,10
80110,Bečej,1,,951,421,951,530,530,0,530,142,388
80110,Bečej,2,,1158,463,1158,695,695,4,691,189,502
80110,Bečej,3,,858,358,858,500,500,3,497,244,253
80110,Bečej,4,,808,375,808,433,433,3,430,183,247
80110,Bečej,5,,1152,525,1152,627,627,10,617,154,463
80110,Bečej,6,,1023,386,1023,637,636,5,631,266,365
80110,Bečej,7,,1024,445,1025,579,579,6,573,240,333
80110,Bečej,8,,1145,506,1145,639,639,3,636,307,329
80110,Bečej,9,,955,416,955,539,539,2,537,222,315
80110,Bečej,10,,956,377,956,579,579,9,570,113,457
80110,Bečej,11,,847,378,847,469,469,1,468,55,413
80110,Bečej,12,,943,453,943,490,490,3,487,95,392
80110,Bečej,13,,867,462,868,405,405,5,400,45,355
80110,Bečej,14,,678,294,679,384,384,6,378,150,228
80110,Bečej,15,,987,391,987,596,596,4,592,321,271
80110,Bečej,16,,1076,446,1076,630,630,9,621,353,268
80110,Bečej,17,,651,319,650,332,332,5,327,105,222
80110,Bečej,18,,206,123,206,83,83,0,83,7,76
80110,Bečej,19,,962,399,962,563,563,3,560,114,446
80110,Bečej,20,,997,471,997,526,526,4,522,162,360
80110,Bečej,21,,872,407,872,465,465,4,461,140,321
80110,Bečej,22,,1144,550,1143,594,594,6,588,99,489
80110,Bečej,23,,888,400,888,488,488,5,483,106,377
80110,Bečej,24,,1105,508,1105,597,597,4,593,96,497
80110,Bečej,25,,849,342,849,507,507,5,502,303,199
80110,Bečej,26,,906,502,906,404,404,3,401,215,186
80110,Bečej,27,,781,372,781,409,409,1,408,100,308
80110,Bečej,28,,864,351,866,513,513,2,511,77,434
80110,Bečej,29,,987,594,987,393,393,7,386,69,317
80110,Bečej,30,,918,408,918,510,510,5,505,220,285
80110,Bečej,31,,1014,432,1014,582,582,5,577,36,541
80110,Bečej,32,,1025,541,1025,484,484,4,480,36,444
80110,Bečej,33,,1054,450,1055,604,604,3,601,174,427
80110,Bečej,34,,1036,549,1036,487,487,4,483,53,430
80110,Bečej,35,,919,445,919,474,474,3,471,43,428
80110,Bečej,36,,414,170,414,244,244,3,241,145,96
80110,Bečej,37,,414,212,414,202,202,1,201,39,162
80110,Bečej,38,,981,347,981,634,634,5,629,527,102
80128,Vršac,1,,1188,520,1188,668,668,7,661,209,452
80128,Vršac,2,,573,303,573,270,270,1,269,89,180
80128,Vršac,3,,850,345,850,505,505,9,496,216,280
80128,Vršac,4,,1083,501,1083,582,582,4,578,187,391
80128,Vršac,5,,1123,543,1123,580,580,7,573,214,359
80128,Vršac,6,,671,271,671,400,400,1,399,111,288
80128,Vršac,7,,858,395,858,463,463,5,458,211,247
80128,Vršac,8,,841,334,841,507,507,11,496,223,273
80128,Vršac,9,,1049,506,1050,543,543,12,531,242,289
80128,Vršac,10,,1809,867,1809,942,942,9,933,512,421
80128,Vršac,11,,926,421,926,505,505,8,497,172,325
80128,Vršac,12,,780,367,780,413,413,2,411,158,253
80128,Vršac,13,,936,418,936,518,518,5,513,165,348
80128,Vršac,14,,884,389,883,495,495,7,488,189,299
80128,Vršac,15,,1060,444,1060,616,616,8,608,196,412
80128,Vršac,16,,930,419,930,511,511,6,505,165,340
80128,Vršac,17,,946,546,946,400,400,3,397,173,224
80128,Vršac,18,,1046,534,1046,512,512,8,504,216,288
80128,Vršac,19,,705,329,705,376,376,5,371,134,237
80128,Vršac,20,,1140,665,1140,475,475,5,470,187,283
80128,Vršac,21,,1103,518,1103,585,585,5,580,231,349
80128,Vršac,22,,1122,480,1132,642,642,6,636,285,351
80128,Vršac,23,,1022,426,1021,596,596,21,575,180,395
80128,Vršac,24,,1309,590,1309,719,719,10,709,300,409
80128,Vršac,25,,1071,485,1071,586,586,5,581,212,369
80128,Vršac,26,,1117,582,1117,535,535,5,530,185,345
80128,Vršac,27,,864,513,864,351,351,3,348,157,191
80128,Vršac,28,,1126,589,1126,537,537,3,534,221,313
80128,Vršac,29,,1311,648,1311,663,663,5,658,279,379
80128,Vršac,30,,1252,625,1252,627,627,7,620,245,375
80128,Vršac,31,,1212,656,1212,556,556,5,551,314,237
80128,Vršac,32,,638,356,638,282,282,4,278,158,120
80128,Vršac,33,,204,86,204,118,118,3,115,55,60
80128,Vršac,34,,316,135,316,181,181,4,177,32,145
80128,Vršac,35,,110,80,110,30,30,0,30,9,21
80128,Vršac,36,,402,243,402,159,159,2,157,18,139
80128,Vršac,37,,1131,586,1131,545,545,10,535,232,303
80128,Vršac,38,,226,115,226,111,111,16,95,14,81
80128,Vršac,39,,400,156,400,244,244,6,238,46,192
80128,Vršac,40,,293,159,293,134,134,2,132,30,102
80128,Vršac,41,,1058,571,1058,487,487,10,477,275,202
80128,Vršac,42,,733,436,733,297,297,5,292,43,249
80128,Vršac,43,,370,190,370,180,180,4,176,119,57
80128,Vršac,44,,1030,542,1030,488,488,4,484,174,310
80128,Vršac,45,,659,330,659,329,329,4,325,167,158
80128,Vršac,46,,719,346,719,373,373,2,371,189,182
80128,Vršac,47,,334,147,334,187,187,5,182,24,158
80128,Vršac,48,,921,604,921,317,317,3,314,175,139
80128,Vršac,49,,1060,666,1060,394,394,2,392,208,184
80128,Vršac,50,,919,629,919,290,290,7,283,115,168
80128,Vršac,51,,709,309,709,400,400,5,395,109,286
80128,Vršac,52,,218,111,218,107,107,4,103,5,98
80128,Vršac,53,,509,234,509,275,275,2,273,133,140
80128,Vršac,54,,357,177,357,180,180,3,177,97,80
80128,Vršac,55,,628,409,628,219,219,3,216,15,201
80128,Vršac,56,,271,136,271,135,135,3,132,70,62
80136,Žabalj,1,,694,345,694,349,349,2,347,209,138
80136,Žabalj,2,,622,277,622,345,345,4,341,234,107
80136,Žabalj,3,,583,264,583,319,319,5,314,213,101
80136,Žabalj,4,,817,358,817,459,459,1,458,359,99
80136,Žabalj,5,,772,428,772,344,344,1,343,230,113
80136,Žabalj,6,,607,304,607,303,303,6,297,228,69
80136,Žabalj,7,,698,352,698,346,346,10,336,191,145
80136,Žabalj,8,,648,280,648,368,368,2,366,94,272
80136,Žabalj,9,,772,405,772,367,367,6,361,222,139
80136,Žabalj,10,,572,266,572,306,306,6,300,172,128
80136,Žabalj,11,,607,290,607,317,317,3,314,170,144
80136,Žabalj,12,,477,217,477,260,260,5,255,133,122
80136,Žabalj,13,,524,227,524,297,297,2,295,212,83
80136,Žabalj,14,,626,274,626,352,352,6,346,171,175
80136,Žabalj,15,,790,381,790,409,408,4,404,242,162
80136,Žabalj,16,,861,437,861,424,424,3,421,263,158
80136,Žabalj,17,,602,325,602,277,277,3,274,204,70
80136,Žabalj,18,,615,286,615,329,329,2,327,268,59
80136,Žabalj,19,,777,357,777,420,420,6,414,330,84
80136,Žabalj,20,,784,382,784,402,402,0,402,343,59
80136,Žabalj,21,,682,350,682,332,332,3,329,201,128
80136,Žabalj,22,,680,341,680,339,339,5,334,203,131
80136,Žabalj,23,,635,329,635,306,306,3,303,215,88
80136,Žabalj,24,,562,281,562,281,281,5,276,178,98
80136,Žabalj,25,,764,368,764,396,396,6,390,271,119
80136,Žabalj,26,,531,258,531,273,273,3,270,149,121
80136,Žabalj,27,,557,346,557,211,211,1,210,131,79
80136,Žabalj,28,,563,269,563,294,294,3,291,163,128
80136,Žabalj,29,,511,255,511,256,256,1,255,195,60
80136,Žabalj,30,,436,198,436,238,238,1,237,185,52
80136,Žabalj,31,,582,215,582,367,367,4,363,319,44
80144,Žitište,1,,635,300,635,335,335,3,332,210,122
80144,Žitište,2,,586,274,586,312,312,4,308,200,108
80144,Žitište,3,,637,299,637,338,338,4,334,238,96
80144,Žitište,4,,682,331,682,351,351,5,346,229,117
80144,Žitište,5,,398,177,398,221,221,4,217,126,91
80144,Žitište,6,,503,236,503,267,267,2,265,80,185
80144,Žitište,7,,481,160,481,321,321,0,321,8,313
80144,Žitište,8,,463,156,463,307,307,1,306,14,292
80144,Žitište,9,,461,136,461,325,325,3,322,7,315
80144,Žitište,10,,551,212,551,339,339,2,337,232,105
80144,Žitište,11,,577,216,577,361,361,7,354,247,107
80144,Žitište,12,,691,353,691,338,338,3,335,231,104
80144,Žitište,13,,781,441,781,340,340,3,337,234,103
80144,Žitište,14,,344,172,344,172,172,1,171,121,50
80144,Žitište,15,,535,259,535,276,276,0,276,86,190
80144,Žitište,16,,454,244,454,210,210,3,207,105,102
80144,Žitište,17,,547,279,547,268,268,4,264,138,126
80144,Žitište,18,,412,218,412,194,194,1,193,106,87
80144,Žitište,19,,504,308,504,196,196,1,195,129,66
80144,Žitište,20,,396,180,396,216,216,6,210,126,84
80144,Žitište,21,,476,212,476,264,264,0,264,179,85
80144,Žitište,22,,587,284,587,303,303,3,300,32,268
80144,Žitište,23,,515,228,515,287,287,2,285,29,256
80144,Žitište,24,,517,319,517,198,198,3,195,32,163
80144,Žitište,25,,515,307,515,208,208,1,207,60,147
80144,Žitište,26,,548,372,548,176,176,0,176,86,90
80144,Žitište,27,,531,327,531,204,204,3,201,38,163
80144,Žitište,28,,505,322,505,183,183,1,182,51,131
80144,Žitište,29,,267,72,267,195,195,2,193,139,54
80144,Žitište,30,,554,269,554,285,285,7,278,231,47
80144,Žitište,31,,538,288,538,250,250,1,249,179,70
80152,Zrenjanin,1,,1292,634,1292,658,658,7,651,103,548
80152,Zrenjanin,2,,1466,749,1468,717,717,7,710,324,386
80152,Zrenjanin,3,,1350,529,1350,821,821,3,818,592,226
80152,Zrenjanin,4,,1177,537,1177,640,640,4,636,89,547
80152,Zrenjanin,5,,1659,852,1659,807,807,12,795,365,430
80152,Zrenjanin,6,,1786,923,1787,863,862,9,853,422,431
80152,Zrenjanin,7,,1754,805,1757,949,949,12,937,595,342
80152,Zrenjanin,8,,1681,855,1683,826,826,10,816,387,429
80152,Zrenjanin,9,,2033,1136,2033,897,897,5,892,430,462
80152,Zrenjanin,10,,501,243,501,258,258,2,256,137,119
80152,Zrenjanin,11,,1266,511,1268,755,755,8,747,475,272
80152,Zrenjanin,12,,1081,465,1081,616,616,3,613,432,181
80152,Zrenjanin,13,,1562,882,1563,680,680,4,676,495,181
80152,Zrenjanin,14,,371,126,371,245,245,1,244,161,83
80152,Zrenjanin,15,,1192,550,1194,642,642,3,639,449,190
80152,Zrenjanin,16,,1072,464,1072,608,608,8,600,421,179
80152,Zrenjanin,17,,462,182,462,280,280,1,279,40,239
80152,Zrenjanin,18,,1697,675,1698,1022,1022,8,1014,595,419
80152,Zrenjanin,19,,1820,945,1841,875,875,0,875,543,332
80152,Zrenjanin,20,,1596,803,1597,793,786,7,779,408,371
80152,Zrenjanin,21,,1711,828,1711,883,883,9,874,516,358
80152,Zrenjanin,22,,840,299,840,541,541,1,540,33,507
80152,Zrenjanin,23,,1415,764,1415,651,651,4,647,356,291
80152,Zrenjanin,24,,1356,621,1360,735,735,6,729,414,315
80152,Zrenjanin,25,,1435,826,1435,609,609,6,603,387,216
80152,Zrenjanin,26,,1623,817,1623,806,806,4,802,541,261
80152,Zrenjanin,27,,848,444,848,404,404,7,397,238,159
80152,Zrenjanin,28,,1258,832,1259,426,426,7,419,234,185
80152,Zrenjanin,29,,1037,557,1037,480,480,12,468,268,200
80152,Zrenjanin,30,,1146,579,1147,567,566,8,558,287,271
80152,Zrenjanin,31,,881,489,879,392,392,3,389,235,154
80152,Zrenjanin,32,,2320,1013,2320,1307,1307,8,1299,484,815
80152,Zrenjanin,33,,2319,974,2322,1345,1342,19,1323,598,725
80152,Zrenjanin,34,,2179,1097,2177,1082,1082,8,1074,485,589
80152,Zrenjanin,35,,2304,1025,2307,1279,1279,16,1263,516,747
80152,Zrenjanin,36,,1369,630,1369,739,739,9,730,327,403
80152,Zrenjanin,37,,1247,537,1245,710,710,5,705,294,411
80152,Zrenjanin,38,,2390,1090,2389,1300,1300,8,1292,563,729
80152,Zrenjanin,39,,1963,804,1963,1159,1159,14,1145,618,527
80152,Zrenjanin,40,,1892,764,1889,1128,1128,22,1106,542,564
80152,Zrenjanin,41,,2403,1132,2407,1271,1271,5,1266,724,542
80152,Zrenjanin,42,,1838,793,1840,1045,1045,10,1035,345,690
80152,Zrenjanin,43,,1795,873,1798,922,922,12,910,367,543
80152,Zrenjanin,44,,2389,972,2390,1417,1415,7,1408,640,768
80152,Zrenjanin,45,,2275,970,2275,1305,1305,17,1288,542,746
80152,Zrenjanin,46,,1660,797,1665,863,862,9,853,381,472
80152,Zrenjanin,47,,1262,564,1263,698,698,6,692,216,476
80152,Zrenjanin,48,,1265,571,1265,694,694,6,688,341,347
80152,Zrenjanin,49,,1221,569,1220,652,651,2,649,294,355
80152,Zrenjanin,50,,2123,982,2122,1141,1141,18,1123,457,666
80152,Zrenjanin,51,,2381,1048,2394,1333,1333,13,1320,610,710
80152,Zrenjanin,52,,2388,1079,2389,1309,1309,13,1296,567,729
80152,Zrenjanin,53,,1620,755,1622,865,865,11,854,332,522
80152,Zrenjanin,54,,2077,893,2078,1184,1184,7,1177,390,787
80152,Zrenjanin,55,,2153,838,2154,1315,1314,24,1290,386,904
80152,Zrenjanin,56,,1837,789,1837,1048,1048,18,1030,425,605
80152,Zrenjanin,57,,1572,603,1573,969,969,6,963,308,655
80152,Zrenjanin,58,,1608,625,1611,983,983,10,973,329,644
80152,Zrenjanin,59,,1597,738,1596,859,859,16,843,364,479
80152,Zrenjanin,60,,1013,449,1014,564,564,8,556,194,362
80152,Zrenjanin,61,,2225,931,2228,1294,1294,17,1277,388,889
80152,Zrenjanin,62,,1622,778,1622,844,844,19,825,329,496
80152,Zrenjanin,63,,1480,665,1482,815,815,9,806,295,511
80152,Zrenjanin,64,,1765,665,1765,1100,1100,10,1090,124,966
80152,Zrenjanin,65,,1059,428,1059,631,631,6,625,216,409
80152,Zrenjanin,66,,1581,659,1581,922,922,5,917,87,830
80152,Zrenjanin,67,,2017,749,2021,1268,1268,11,1257,72,1185
80179,Inđija,1,,877,380,877,497,497,4,493,303,190
80179,Inđija,2,,887,373,887,514,514,4,510,322,188
80179,Inđija,3,,1068,466,1068,602,602,3,599,384,215
80179,Inđija,4,,1008,409,1008,599,599,3,596,332,264
80179,Inđija,5,,890,406,890,484,484,7,477,245,232
80179,Inđija,6,,1074,458,1075,616,616,6,610,328,282
80179,Inđija,7,,1184,556,1184,628,628,6,622,318,304
80179,Inđija,8,,1086,454,1086,632,632,8,624,376,248
80179,Inđija,9,,1062,499,1062,563,563,1,562,338,224
80179,Inđija,10,,1082,528,1082,554,554,9,545,324,221
80179,Inđija,11,,1106,506,1106,600,600,7,593,340,253
80179,Inđija,12,,1250,580,1249,670,670,10,660,367,293
80179,Inđija,13,,1127,459,1128,668,668,6,662,404,258
80179,Inđija,14,,1250,517,1250,733,733,4,729,421,308
80179,Inđija,15,,1500,646,1500,854,853,6,847,479,368
80179,Inđija,16,,1440,654,1440,786,785,11,774,396,378
80179,Inđija,17,,1690,842,1690,848,848,7,841,497,344
80179,Inđija,18,,1025,442,1025,583,583,4,579,333,246
80179,Inđija,19,,1378,666,1378,712,712,8,704,372,332
80179,Inđija,20,,1328,594,1328,734,734,3,731,452,279
80179,Inđija,21,,1051,445,1051,606,606,7,599,375,224
80179,Inđija,22,,1163,502,1162,661,661,4,657,437,220
80179,Inđija,23,,1059,488,1059,571,571,10,561,353,208
80179,Inđija,24,,1023,470,1024,553,553,3,550,364,186
80179,Inđija,25,,281,137,281,144,144,0,144,39,105
80179,Inđija,26,,1196,568,1196,628,628,10,618,515,103
80179,Inđija,27,,393,188,393,205,205,1,204,164,40
80179,Inđija,28,,924,467,924,457,456,4,452,271,181
80179,Inđija,29,,713,363,713,350,350,2,348,123,225
80179,Inđija,30,,1202,597,1202,605,605,10,595,326,269
80179,Inđija,31,,1097,617,1097,480,480,7,473,291,182
80179,Inđija,32,,750,378,750,372,372,6,366,200,166
80179,Inđija,33,,842,431,842,411,411,9,402,265,137
80179,Inđija,34,,946,412,946,534,534,10,524,331,193
80179,Inđija,35,,523,223,523,300,300,3,297,127,170
80179,Inđija,36,,1305,636,1305,669,669,7,662,473,189
80187,Irig,1,,703,365,702,338,338,3,335,206,129
80187,Irig,2,,745,333,744,412,412,11,401,158,243
80187,Irig,3,,1024,494,1024,530,530,10,520,227,293
80187,Irig,4,,1004,529,1004,475,475,3,472,274,198
80187,Irig,5,,477,213,477,264,264,10,254,174,80
80187,Irig,6,,683,352,683,331,331,3,328,208,120
80187,Irig,7,,1165,588,1167,577,577,10,567,263,304
80187,Irig,8,,733,335,733,398,398,1,397,167,230
80187,Irig,9,,857,472,857,385,385,2,383,262,121
80187,Irig,10,,120,60,120,60,60,0,60,45,15
80187,Irig,11,,390,200,390,190,190,2,188,120,68
80187,Irig,12,,230,120,230,110,110,1,109,84,25
80187,Irig,13,,272,121,272,151,151,1,150,105,45
80187,Irig,14,,380,151,380,229,229,1,228,64,164
80195,Kanjia,1,,835,347,835,488,488,5,483,47,436
80195,Kanjia,2,,370,152,369,218,218,1,217,10,207
80195,Kanjia,3,,452,157,442,295,295,2,293,6,287
80195,Kanjia,4,,352,135,363,217,217,2,215,15,200
80195,Kanjia,5,,555,219,555,336,336,0,336,46,290
80195,Kanjia,6,,504,208,504,296,296,1,295,34,261
80195,Kanjia,7,,401,195,401,206,206,3,203,10,193
80195,Kanjia,8,,383,167,383,216,216,0,216,9,207
80195,Kanjia,9,,390,176,390,214,214,1,213,25,188
80195,Kanjia,10,,533,223,533,310,310,0,310,9,301
80195,Kanjia,11,,661,340,661,321,321,1,320,7,313
80195,Kanjia,12,,483,237,483,246,246,4,242,25,217
80195,Kanjia,13,,337,166,337,171,171,2,169,4,165
80195,Kanjia,14,,887,310,887,577,577,2,575,14,561
80195,Kanjia,15,,809,327,809,482,482,7,475,29,446
80195,Kanjia,16,,794,297,794,497,497,3,494,17,477
80195,Kanjia,17,,824,346,824,478,478,0,478,19,459
80195,Kanjia,18,,780,276,783,504,504,3,501,22,479
80195,Kanjia,19,,875,344,876,531,531,5,526,79,447
80195,Kanjia,20,,823,315,823,508,508,3,505,51,454
80195,Kanjia,21,,873,341,873,532,532,5,527,33,494
80195,Kanjia,22,,1056,383,1056,673,673,3,670,16,654
80195,Kanjia,23,,877,348,877,529,529,0,529,17,512
80195,Kanjia,24,,663,306,663,357,357,3,354,21,333
80195,Kanjia,25,,706,254,706,452,452,4,448,13,435
80195,Kanjia,26,,646,289,646,357,357,1,356,11,345
80195,Kanjia,27,,218,57,227,161,161,0,161,0,161
80195,Kanjia,28,,505,251,505,254,254,2,252,30,222
80195,Kanjia,29,,522,248,522,274,274,7,267,14,253
80195,Kanjia,30,,718,328,718,390,390,4,386,25,361
80195,Kanjia,31,,148,54,148,94,94,0,94,2,92
80195,Kanjia,32,,634,183,634,451,451,2,449,7,442
80195,Kanjia,33,,564,184,564,380,380,4,376,10,366
80195,Kanjia,34,,431,195,431,236,236,1,235,9,226
80195,Kanjia,35,,293,120,293,173,173,0,173,20,153
80195,Kanjia,36,,558,264,558,294,294,4,290,10,280
80195,Kanjia,37,,388,165,388,223,223,1,222,1,221
80195,Kanjia,38,,633,264,633,369,369,1,368,5,363
80195,Kanjia,39,,527,156,527,371,371,3,368,10,358
80195,Kanjia,40,,257,118,257,139,139,2,137,75,62
80195,Kanjia,41,,251,100,251,151,151,1,150,71,79
80209,Kikinda,1,,1110,530,1110,580,580,4,576,225,351
80209,Kikinda,2,,957,348,957,609,609,6,603,214,389
80209,Kikinda,3,,971,403,971,568,568,7,561,202,359
80209,Kikinda,4,,886,409,887,477,477,2,475,195,280
80209,Kikinda,5,,1147,461,1148,686,686,9,677,326,351
80209,Kikinda,6,,1269,590,1269,679,679,4,675,432,243
80209,Kikinda,7,,858,368,858,490,490,2,488,179,309
80209,Kikinda,8,,723,301,723,422,422,7,415,158,257
80209,Kikinda,9,,976,420,976,556,556,3,553,223,330
80209,Kikinda,10,,990,480,990,510,509,5,504,237,267
80209,Kikinda,11,,851,400,850,451,451,4,447,195,252
80209,Kikinda,12,,982,392,982,590,590,17,573,260,313
80209,Kikinda,13,,847,362,848,485,485,3,482,185,297
80209,Kikinda,14,,1054,532,1054,522,522,5,517,223,294
80209,Kikinda,15,,961,351,962,610,610,6,604,248,356
80209,Kikinda,16,,925,340,926,585,585,7,578,313,265
80209,Kikinda,17,,1085,548,1085,537,537,3,534,288,246
80209,Kikinda,18,,910,432,910,478,478,4,474,247,227
80209,Kikinda,19,,1016,471,1016,545,545,6,539,338,201
80209,Kikinda,20,,1103,500,1104,603,602,4,598,361,237
80209,Kikinda,21,,1179,494,1179,685,685,10,675,294,381
80209,Kikinda,22,,1017,407,1018,610,610,8,602,262,340
80209,Kikinda,23,,973,423,974,550,550,10,540,226,314
80209,Kikinda,24,,998,384,998,614,614,11,603,197,406
80209,Kikinda,25,,1144,458,1144,686,686,9,677,211,466
80209,Kikinda,26,,1103,480,1103,623,623,6,617,259,358
80209,Kikinda,27,,1005,492,1005,513,513,1,512,261,251
80209,Kikinda,28,,1216,565,1215,651,650,4,646,267,379
80209,Kikinda,29,,1039,400,1039,639,639,8,631,224,407
80209,Kikinda,30,,1258,582,1258,676,676,7,669,351,318
80209,Kikinda,31,,1094,434,1094,660,660,17,643,201,442
80209,Kikinda,32,,1039,398,1039,641,641,10,631,283,348
80209,Kikinda,33,,1014,443,1014,571,571,5,566,266,300
80209,Kikinda,34,,1092,512,1092,580,580,10,570,336,234
80209,Kikinda,35,,932,458,932,474,474,5,469,324,145
80209,Kikinda,36,,966,450,966,516,515,8,507,354,153
80209,Kikinda,37,,1196,543,1196,653,653,7,646,404,242
80209,Kikinda,38,,521,189,521,332,332,3,329,255,74
80209,Kikinda,39,,718,303,721,415,415,5,410,296,114
80209,Kikinda,40,,996,404,996,592,592,4,588,437,151
80209,Kikinda,41,,893,360,893,533,533,3,530,408,122
80209,Kikinda,42,,966,423,966,543,543,6,537,235,302
80209,Kikinda,43,,719,369,719,350,350,1,349,65,284
80209,Kikinda,44,,856,317,854,539,539,3,536,429,107
80209,Kikinda,45,,694,261,694,433,433,5,428,198,230
80209,Kikinda,46,,227,111,224,116,116,0,116,83,33
80209,Kikinda,47,,758,393,758,365,365,6,359,253,106
80209,Kikinda,48,,893,418,893,475,475,11,464,286,178
80209,Kikinda,49,,789,385,796,404,404,2,402,303,99
80209,Kikinda,50,,173,82,173,91,91,0,91,60,31
80209,Kikinda,51,,875,415,875,460,460,7,453,241,212
80209,Kikinda,52,,878,492,879,386,386,3,383,213,170
80209,Kikinda,53,,994,575,995,419,419,8,411,284,127
80209,Kikinda,54,,975,479,975,496,496,5,491,362,129
80209,Kikinda,55,,893,388,893,505,505,10,495,249,246
80209,Kikinda,56,,756,329,756,427,427,6,421,290,131
80209,Kikinda,57,,856,348,856,508,508,6,502,319,183
80209,Kikinda,58,,501,228,501,273,273,4,269,22,247
80209,Kikinda,59,,560,254,566,306,306,2,304,19,285
80217,Kovačica,1,,594,274,594,320,320,3,317,152,165
80217,Kovačica,2,,721,297,721,424,424,5,419,100,319
80217,Kovačica,3,,666,276,666,390,390,6,384,58,326
80217,Kovačica,4,,538,214,538,324,324,5,319,59,260
80217,Kovačica,5,,596,226,596,370,370,1,369,37,332
80217,Kovačica,6,,653,295,653,358,358,2,356,81,275
80217,Kovačica,7,,690,299,690,391,391,4,387,96,291
80217,Kovačica,8,,679,272,679,407,407,9,398,67,331
80217,Kovačica,9,,652,271,652,381,381,5,376,38,338
80217,Kovačica,10,,642,280,642,362,362,3,359,40,319
80217,Kovačica,11,,665,272,665,393,393,2,391,58,333
80217,Kovačica,12,,564,208,564,356,356,9,347,28,319
80217,Kovačica,13,,593,249,593,344,344,13,331,31,300
80217,Kovačica,14,,641,321,641,320,320,7,313,47,266
80217,Kovačica,15,,625,322,625,303,303,4,299,24,275
80217,Kovačica,16,,717,363,717,354,354,6,348,36,312
80217,Kovačica,17,,467,290,467,177,177,1,176,132,44
80217,Kovačica,18,,448,256,448,192,192,0,192,108,84
80217,Kovačica,19,,605,327,605,278,278,3,275,17,258
80217,Kovačica,20,,629,374,629,255,255,2,253,25,228
80217,Kovačica,21,,670,354,670,316,316,2,314,33,281
80217,Kovačica,22,,682,401,682,281,281,4,277,30,247
80217,Kovačica,23,,672,375,672,297,297,6,291,29,262
80217,Kovačica,24,,630,325,630,305,305,4,301,22,279
80217,Kovačica,25,,572,357,572,215,215,5,210,18,192
80217,Kovačica,26,,608,329,608,279,279,5,274,50,224
80217,Kovačica,27,,173,60,173,113,113,3,110,78,32
80217,Kovačica,28,,505,285,505,220,220,2,218,128,90
80217,Kovačica,29,,488,300,488,188,188,5,183,125,58
80217,Kovačica,30,,597,345,597,252,252,2,250,27,223
80217,Kovačica,31,,521,314,521,207,207,2,205,31,174
80217,Kovačica,32,,620,365,620,255,255,8,247,40,207
80217,Kovačica,33,,617,415,617,202,202,3,199,57,142
80217,Kovačica,34,,647,378,647,269,269,2,267,139,128
80217,Kovačica,35,,618,388,618,230,230,3,227,141,86
80217,Kovačica,36,,574,321,574,253,253,2,251,135,116
80217,Kovačica,37,,631,342,631,289,289,5,284,229,55
80217,Kovačica,38,,641,335,641,306,306,0,306,173,133
80217,Kovačica,39,,684,399,684,285,285,7,278,188,90
80225,Kovin,1,,2305,1159,2305,1146,1146,10,1136,550,586
80225,Kovin,2,,1670,740,1670,930,930,16,914,315,599
80225,Kovin,3,,1564,785,1568,779,779,20,759,330,429
80225,Kovin,4,,1893,858,1893,1035,1035,13,1022,358,664
80225,Kovin,5,,1652,859,1652,793,793,13,780,392,388
80225,Kovin,6,,945,425,945,520,520,9,511,264,247
80225,Kovin,7,,1487,786,1487,701,701,13,688,321,367
80225,Kovin,8,,1326,885,1326,441,441,5,436,246,190
80225,Kovin,9,,1205,650,1205,555,555,4,551,301,250
80225,Kovin,10,,1318,718,1318,600,600,3,597,353,244
80225,Kovin,11,,1059,602,1059,457,457,4,453,289,164
80225,Kovin,12,,1280,687,1280,593,593,8,585,290,295
80225,Kovin,13,,1343,776,1343,567,567,9,558,290,268
80225,Kovin,14,,1189,626,1189,563,563,7,556,275,281
80225,Kovin,15,,1239,651,1239,588,588,11,577,294,283
80225,Kovin,16,,1275,735,1275,540,540,6,534,309,225
80225,Kovin,17,,1304,801,1304,503,501,9,492,267,225
80225,Kovin,18,,1220,615,1221,605,605,2,603,34,569
80225,Kovin,19,,1126,530,1126,596,596,6,590,47,543
80225,Kovin,20,,1505,856,1505,649,649,18,631,408,223
80225,Kovin,21,,142,109,142,33,33,0,33,26,7
80225,Kovin,22,,1113,670,1113,443,443,3,440,234,206
80225,Kovin,23,,142,72,142,70,70,2,68,20,48
80225,Kovin,24,,366,216,366,150,150,1,149,100,49
80233,Kula,1,,974,501,974,473,473,6,467,287,180
80233,Kula,2,,1045,481,1045,564,564,7,557,272,285
80233,Kula,3,,945,480,945,465,465,1,464,330,134
80233,Kula,4,,931,439,931,492,492,11,481,202,279
80233,Kula,5,,907,422,908,485,485,0,485,241,244
80233,Kula,6,,831,403,831,428,428,5,423,198,225
80233,Kula,7,,1211,495,1211,716,716,7,709,370,339
80233,Kula,8,,1223,528,1223,695,695,8,687,329,358
80233,Kula,9,,1040,481,1040,559,559,8,551,307,244
80233,Kula,10,,897,411,897,486,486,5,481,283,198
80233,Kula,11,,1224,533,1224,691,691,5,686,430,256
80233,Kula,12,,1180,544,1180,636,636,11,625,308,317
80233,Kula,13,,858,364,858,494,494,5,489,164,325
80233,Kula,14,,915,399,915,516,516,5,511,105,406
80233,Kula,15,,962,544,962,418,418,5,413,198,215
80233,Kula,16,,1017,406,1017,611,611,8,603,387,216
80233,Kula,17,,173,98,173,75,75,1,74,54,20
80233,Kula,18,,802,319,802,483,483,6,477,336,141
80233,Kula,19,,859,321,859,538,538,2,536,414,122
80233,Kula,20,,889,455,889,434,434,2,432,311,121
80233,Kula,21,,1374,611,1374,763,763,14,749,496,253
80233,Kula,22,,1142,527,1142,615,615,3,612,469,143
80233,Kula,23,,876,458,876,418,418,5,413,288,125
80233,Kula,24,,634,302,634,332,332,3,329,220,109
80233,Kula,25,,388,174,388,214,214,3,211,154,57
80233,Kula,26,,710,360,710,350,350,6,344,247,97
80233,Kula,27,,1086,593,1086,493,493,4,489,345,144
80233,Kula,28,,1047,498,1046,549,549,0,549,336,213
80233,Kula,29,,915,445,915,470,470,4,466,235,231
80233,Kula,30,,730,344,731,386,386,2,384,201,183
80233,Kula,31,,1112,586,1112,526,526,3,523,320,203
80233,Kula,32,,1104,512,1104,592,592,6,586,436,150
80233,Kula,33,,1069,502,1069,567,567,7,560,48,512
80233,Kula,34,,949,459,949,490,490,3,487,52,435
80233,Kula,35,,1013,540,1013,473,473,11,462,64,398
80233,Kula,36,,1048,468,1037,580,580,7,573,65,508
80233,Kula,37,,920,445,920,475,475,9,466,283,183
80233,Kula,38,,856,412,857,444,444,9,435,324,111
80233,Kula,39,,1257,624,1269,633,633,12,621,435,186
80241,Mali Iđoš,1,,436,190,436,246,246,1,245,21,224
80241,Mali Iđoš,2,,392,193,392,199,199,0,199,11,188
80241,Mali Iđoš,3,,539,233,539,306,306,6,300,20,280
80241,Mali Iđoš,4,,495,249,495,246,246,2,244,29,215
80241,Mali Iđoš,5,,449,184,449,265,265,3,262,23,239
80241,Mali Iđoš,6,,430,186,430,244,244,1,243,19,224
80241,Mali Iđoš,7,,446,209,446,237,237,1,236,9,227
80241,Mali Iđoš,8,,357,149,357,208,208,2,206,17,189
80241,Mali Iđoš,9,,444,204,444,240,240,0,240,17,223
80241,Mali Iđoš,10,,489,206,489,283,283,1,282,6,276
80241,Mali Iđoš,11,,372,193,372,179,179,1,178,109,69
80241,Mali Iđoš,12,,332,159,332,173,173,2,171,111,60
80241,Mali Iđoš,13,,425,219,425,206,206,3,203,133,70
80241,Mali Iđoš,14,,433,203,433,230,230,1,229,172,57
80241,Mali Iđoš,15,,435,219,435,216,216,0,216,153,63
80241,Mali Iđoš,16,,377,179,377,198,198,3,195,105,90
80241,Mali Iđoš,17,,479,233,479,246,246,4,242,171,71
80241,Mali Iđoš,18,,300,118,300,182,182,2,180,90,90
80241,Mali Iđoš,19,,481,235,481,246,246,4,242,103,139
80241,Mali Iđoš,20,,338,138,338,200,200,3,197,21,176
80241,Mali Iđoš,21,,387,189,387,198,198,2,196,22,174
80241,Mali Iđoš,22,,422,191,422,231,231,3,228,105,123
80241,Mali Iđoš,23,,486,233,486,253,253,2,251,52,199
80241,Mali Iđoš,24,,412,190,412,222,222,0,222,52,170
80241,Mali Iđoš,25,,504,216,504,288,288,1,287,33,254
80250,Nova Crnja,1,,505,241,505,264,264,5,259,165,94
80250,Nova Crnja,2,,454,234,454,220,220,5,215,147,68
80250,Nova Crnja,3,,354,197,354,157,157,4,153,103,50
80250,Nova Crnja,4,,320,169,320,151,151,2,149,96,53
80250,Nova Crnja,5,,295,128,295,167,167,7,160,91,69
80250,Nova Crnja,6,,487,212,487,275,275,1,274,5,269
80250,Nova Crnja,7,,293,124,293,169,169,1,168,8,160
80250,Nova Crnja,8,,401,145,401,256,256,1,255,10,245
80250,Nova Crnja,9,,384,146,384,238,238,0,238,31,207
80250,Nova Crnja,10,,272,81,272,191,191,3,188,12,176
80250,Nova Crnja,11,,253,75,253,178,178,2,176,2,174
80250,Nova Crnja,12,,371,171,371,200,200,2,198,133,65
80250,Nova Crnja,13,,483,198,483,285,285,5,280,169,111
80250,Nova Crnja,14,,422,189,422,233,233,6,227,136,91
80250,Nova Crnja,15,,377,157,377,220,220,1,219,102,117
80250,Nova Crnja,16,,293,117,293,176,176,2,174,63,111
80250,Nova Crnja,17,,359,150,359,209,209,2,207,104,103
80250,Nova Crnja,18,,394,146,394,248,248,4,244,110,134
80250,Nova Crnja,19,,369,158,369,211,211,4,207,117,90
80250,Nova Crnja,20,,395,149,395,246,246,6,240,140,100
80250,Nova Crnja,21,,369,151,369,218,218,4,214,122,92
80250,Nova Crnja,22,,426,184,426,242,242,3,239,141,98
80250,Nova Crnja,23,,395,169,395,226,226,8,218,115,103
80250,Nova Crnja,24,,393,186,393,207,207,8,199,109,90
80250,Nova Crnja,25,,327,142,327,185,185,3,182,117,65
80250,Nova Crnja,26,,284,141,284,143,143,6,137,88,49
80268,Novi Bečej,1,,682,284,682,398,398,8,390,143,247
80268,Novi Bečej,2,,808,362,808,446,446,5,441,120,321
80268,Novi Bečej,3,,602,274,602,328,328,6,322,129,193
80268,Novi Bečej,4,,694,336,694,358,358,2,356,143,213
80268,Novi Bečej,5,,629,265,629,364,364,5,359,86,273
80268,Novi Bečej,6,,560,238,558,322,322,4,318,74,244
80268,Novi Bečej,7,,838,408,838,430,430,4,426,85,341
80268,Novi Bečej,8,,565,306,565,259,259,6,253,37,216
80268,Novi Bečej,9,,757,384,757,373,373,5,368,177,191
80268,Novi Bečej,10,,834,367,834,467,467,5,462,131,331
80268,Novi Bečej,11,,805,403,805,402,402,6,396,175,221
80268,Novi Bečej,12,,728,496,728,232,232,4,228,134,94
80268,Novi Bečej,13,,746,357,746,389,389,4,385,224,161
80268,Novi Bečej,14,,786,381,786,405,405,6,399,118,281
80268,Novi Bečej,15,,598,289,598,309,309,1,308,247,61
80268,Novi Bečej,16,,672,314,672,358,358,7,351,260,91
80268,Novi Bečej,17,,744,360,744,384,384,6,378,95,283
80268,Novi Bečej,18,,641,311,641,330,330,5,325,159,166
80268,Novi Bečej,19,,687,395,687,292,292,6,286,176,110
80268,Novi Bečej,20,,585,301,585,284,284,2,282,135,147
80268,Novi Bečej,21,,733,409,733,324,324,2,322,187,135
80268,Novi Bečej,22,,647,331,647,316,316,3,313,212,101
80268,Novi Bečej,23,,473,235,473,238,238,2,236,137,99
80268,Novi Bečej,24,,664,320,664,344,344,5,339,279,60
80268,Novi Bečej,25,,609,321,609,288,288,5,283,164,119
80268,Novi Bečej,26,,543,299,543,244,244,4,240,153,87
80268,Novi Bečej,27,,585,321,587,264,263,6,257,187,70
80268,Novi Bečej,28,,556,277,556,279,279,1,278,178,100
80268,Novi Bečej,29,,488,183,588,305,305,1,304,178,126
80268,Novi Bečej,30,,625,286,625,339,339,7,332,236,96
80268,Novi Bečej,31,,702,284,702,418,418,4,414,258,156
80276,Novi Kneževac,1,,188,94,188,94,94,0,94,37,57
80276,Novi Kneževac,2,,148,70,148,78,78,1,77,34,43
80276,Novi Kneževac,3,,315,121,315,194,194,2,192,76,116
80276,Novi Kneževac,4,,312,147,312,165,165,1,164,64,100
80276,Novi Kneževac,5,,359,134,359,225,225,4,221,87,134
80276,Novi Kneževac,6,,354,125,354,229,229,0,229,85,144
80276,Novi Kneževac,7,,348,138,348,210,210,1,209,108,101
80276,Novi Kneževac,8,,333,125,333,208,208,3,205,87,118
80276,Novi Kneževac,9,,340,123,340,217,217,1,216,99,117
80276,Novi Kneževac,10,,302,97,302,205,205,2,203,48,155
80276,Novi Kneževac,11,,369,161,369,208,208,2,206,85,121
80276,Novi Kneževac,12,,389,113,389,276,276,5,271,102,169
80276,Novi Kneževac,13,,335,125,335,210,210,0,210,96,114
80276,Novi Kneževac,14,,272,93,272,179,179,2,177,25,152
80276,Novi Kneževac,15,,294,93,294,201,201,1,200,59,141
80276,Novi Kneževac,16,,353,147,353,206,206,0,206,91,115
80276,Novi Kneževac,17,,485,201,485,284,284,4,280,121,159
80276,Novi Kneževac,18,,307,118,307,189,189,1,188,48,140
80276,Novi Kneževac,19,,346,166,346,180,180,1,179,49,130
80276,Novi Kneževac,20,,272,126,272,146,146,2,144,80,64
80276,Novi Kneževac,21,,316,137,316,179,179,3,176,90,86
80276,Novi Kneževac,22,,444,219,444,225,225,9,216,162,54
80276,Novi Kneževac,23,,149,68,149,81,81,1,80,56,24
80276,Novi Kneževac,24,,150,63,150,87,87,0,87,47,40
80276,Novi Kneževac,25,,295,154,295,141,141,4,137,86,51
80276,Novi Kneževac,26,,285,95,285,190,190,5,185,134,51
80276,Novi Kneževac,27,,164,76,164,88,88,1,87,44,43
80276,Novi Kneževac,28,,130,17,130,113,113,5,108,93,15
80276,Novi Kneževac,29,,350,182,350,168,168,3,165,91,74
80276,Novi Kneževac,30,,307,149,307,158,158,1,157,79,78
80276,Novi Kneževac,31,,287,150,287,137,137,3,134,51,83
80276,Novi Kneževac,32,,106,52,106,54,54,1,53,13,40
80276,Novi Kneževac,33,,193,91,193,102,102,2,100,82,18
80276,Novi Kneževac,34,,132,87,132,45,45,0,45,11,34
80276,Novi Kneževac,35,,101,39,101,62,62,1,61,10,51
80276,Novi Kneževac,36,,132,39,132,93,93,0,93,10,83
80276,Novi Kneževac,37,,108,33,108,75,75,0,75,9,66
80284,Novi Sad-grad,1,,1300,662,1300,638,638,8,630,367,263
80284,Novi Sad-grad,2,,1329,702,1328,627,627,4,623,367,256
80284,Novi Sad-grad,3,,1868,841,1872,1027,1027,4,1023,679,344
80284,Novi Sad-grad,4,,1684,727,1685,957,957,7,950,744,206
80284,Novi Sad-grad,5,,1913,797,1913,1116,1116,8,1108,848,260
80284,Novi Sad-grad,6,,1404,580,1404,824,824,11,813,479,334
80284,Novi Sad-grad,7,,1913,875,1915,1038,1038,9,1029,721,308
80284,Novi Sad-grad,8,,1916,929,1914,987,987,9,978,644,334
80284,Novi Sad-grad,9,,2213,947,2212,1266,1265,15,1250,896,354
80284,Novi Sad-grad,10,,2220,1094,2220,1126,1125,13,1112,709,403
80284,Novi Sad-grad,11,,1707,820,1707,887,887,11,876,673,203
80284,Novi Sad-grad,12,,1567,848,1567,719,719,11,708,431,277
80284,Novi Sad-grad,13,,1554,805,1554,749,749,3,746,437,309
80284,Novi Sad-grad,14,,1720,819,1721,901,901,12,889,547,342
80284,Novi Sad-grad,15,,1784,883,1784,901,901,9,892,587,305
80284,Novi Sad-grad,16,,1739,843,1741,896,896,4,892,721,171
80284,Novi Sad-grad,17,,1732,784,1732,948,948,3,945,567,378
80284,Novi Sad-grad,18,,1773,1010,1773,763,763,6,757,497,260
80284,Novi Sad-grad,19,,1868,898,1869,970,970,3,967,674,293
80284,Novi Sad-grad,20,,1918,982,1918,936,936,11,925,476,449
80284,Novi Sad-grad,21,,1838,998,1838,840,840,8,832,408,424
80284,Novi Sad-grad,22,,1532,729,1532,803,803,3,800,362,438
80284,Novi Sad-grad,23,,1719,754,1719,965,965,18,947,428,519
80284,Novi Sad-grad,24,,1033,479,1033,554,554,5,549,247,302
80284,Novi Sad-grad,25,,1634,867,1634,767,767,3,764,368,396
80284,Novi Sad-grad,26,,1595,791,1596,804,804,7,797,331,466
80284,Novi Sad-grad,27,,1917,949,1918,968,966,6,960,324,636
80284,Novi Sad-grad,28,,1770,836,1770,934,934,16,918,263,655
80284,Novi Sad-grad,29,,1403,653,1401,750,750,6,744,287,457
80284,Novi Sad-grad,30,,1881,887,1882,994,994,6,988,348,640
80284,Novi Sad-grad,31,,1477,659,1473,818,815,7,808,235,573
80284,Novi Sad-grad,32,,1767,895,1766,872,872,16,856,220,636
80284,Novi Sad-grad,33,,1324,602,1328,722,722,7,715,199,516
80284,Novi Sad-grad,34,,1291,621,1291,670,670,5,665,189,476
80284,Novi Sad-grad,35,,971,469,970,502,502,5,497,133,364
80284,Novi Sad-grad,36,,1738,883,1691,855,855,16,839,385,454
80284,Novi Sad-grad,37,,2217,1115,2223,1102,1102,21,1081,351,730
80284,Novi Sad-grad,38,,1105,565,1105,540,540,6,534,211,323
80284,Novi Sad-grad,39,,1718,840,1620,878,878,10,868,355,513
80284,Novi Sad-grad,40,,1618,781,1619,837,837,9,828,360,468
80284,Novi Sad-grad,41,,1430,682,1430,748,748,14,734,326,408
80284,Novi Sad-grad,42,,1361,643,1361,718,718,4,714,471,243
80284,Novi Sad-grad,43,,1254,589,1253,665,664,5,659,274,385
80284,Novi Sad-grad,44,,1668,837,1668,831,830,9,821,266,555
80284,Novi Sad-grad,45,,1777,865,1776,912,912,12,900,234,666
80284,Novi Sad-grad,46,,1584,741,1586,843,843,8,835,321,514
80284,Novi Sad-grad,47,,1705,804,1706,901,900,11,889,480,409
80284,Novi Sad-grad,48,,1289,564,1290,725,724,4,720,250,470
80284,Novi Sad-grad,49,,1952,888,1953,1064,1064,11,1053,400,653
80284,Novi Sad-grad,50,,1439,635,1439,804,804,7,797,321,476
80284,Novi Sad-grad,51,,1116,498,1112,618,618,3,615,341,274
80284,Novi Sad-grad,52,,983,453,984,530,530,5,525,151,374
80284,Novi Sad-grad,53,,1926,781,1924,1145,1145,6,1139,487,652
80284,Novi Sad-grad,54,,1032,410,1032,622,622,5,617,189,428
80284,Novi Sad-grad,55,,1230,564,1230,666,665,11,654,284,370
80284,Novi Sad-grad,56,,1497,643,1498,854,854,6,848,352,496
80284,Novi Sad-grad,57,,1456,652,1457,804,804,10,794,351,443
80284,Novi Sad-grad,58,,1504,763,1504,741,741,10,731,303,428
80284,Novi Sad-grad,59,,1633,683,1633,950,950,10,940,333,607
80284,Novi Sad-grad,60,,1704,760,1703,944,944,15,929,351,578
80284,Novi Sad-grad,61,,1029,501,1030,528,528,4,524,198,326
80284,Novi Sad-grad,62,,1626,679,1626,947,947,4,943,453,490
80284,Novi Sad-grad,63,,1452,648,1453,804,804,11,793,482,311
80284,Novi Sad-grad,64,,1396,606,1396,790,790,9,781,464,317
80284,Novi Sad-grad,65,,1682,783,1683,899,899,19,880,402,478
80284,Novi Sad-grad,66,,1483,714,1484,769,769,8,761,392,369
80284,Novi Sad-grad,67,,1829,874,1829,955,955,10,945,412,533
80284,Novi Sad-grad,68,,1985,894,1984,1091,1090,16,1074,521,553
80284,Novi Sad-grad,69,,1523,713,1524,810,810,12,798,394,404
80284,Novi Sad-grad,70,,1708,812,1708,896,896,7,889,376,513
80284,Novi Sad-grad,71,,2268,1114,2268,1154,1147,23,1124,655,469
80284,Novi Sad-grad,72,,2023,1011,1999,1012,1012,12,1000,458,542
80284,Novi Sad-grad,73,,1536,871,1536,665,665,7,658,474,184
80284,Novi Sad-grad,74,,1494,711,1494,783,783,5,778,599,179
80284,Novi Sad-grad,75,,1546,756,1545,790,790,6,784,565,219
80284,Novi Sad-grad,76,,1372,797,1372,575,575,1,574,338,236
80284,Novi Sad-grad,77,,1415,797,1415,618,618,2,616,370,246
80284,Novi Sad-grad,78,,1400,696,1401,704,704,6,698,395,303
80284,Novi Sad-grad,79,,2064,1040,2070,1024,1024,5,1019,707,312
80284,Novi Sad-grad,80,,1004,519,1005,485,485,3,482,259,223
80284,Novi Sad-grad,81,,791,357,792,434,434,2,432,320,112
80284,Novi Sad-grad,82,,1362,687,1362,675,675,5,670,366,304
80284,Novi Sad-grad,83,,1411,729,1413,682,682,10,672,424,248
80284,Novi Sad-grad,84,,149,80,149,69,69,3,66,49,17
80284,Novi Sad-grad,85,,1074,409,1074,665,665,4,661,27,634
80284,Novi Sad-grad,86,,1159,447,1159,712,712,4,708,23,685
80284,Novi Sad-grad,87,,1066,438,1066,628,628,3,625,56,569
80284,Novi Sad-grad,88,,1189,618,1190,571,571,5,566,152,414
80284,Novi Sad-grad,89,,1698,734,1698,964,964,12,952,318,634
80284,Novi Sad-grad,90,,1442,590,1442,852,850,10,840,287,553
80284,Novi Sad-grad,91,,1742,877,1743,865,865,10,855,295,560
80284,Novi Sad-grad,92,,858,458,858,400,400,4,396,163,233
80284,Novi Sad-grad,93,,1512,649,1512,863,863,13,850,239,611
80284,Novi Sad-grad,94,,1256,620,1257,636,635,10,625,215,410
80284,Novi Sad-grad,95,,1135,547,1126,588,588,9,579,198,381
80284,Novi Sad-grad,96,,1888,1058,1888,830,830,9,821,330,491
80284,Novi Sad-grad,97,,1858,906,1858,952,952,8,944,424,520
80284,Novi Sad-grad,98,,698,394,698,304,304,3,301,124,177
80284,Novi Sad-grad,99,,1367,759,1367,608,608,7,601,376,225
80284,Novi Sad-grad,100,,1392,537,1392,855,855,8,847,697,150
80284,Novi Sad-grad,101,,1547,708,1547,839,839,1,838,610,228
80284,Novi Sad-grad,102,,1512,703,1511,809,809,5,804,586,218
80284,Novi Sad-grad,103,,1426,593,1426,833,833,8,825,579,246
80284,Novi Sad-grad,104,,1596,758,1597,838,838,7,831,581,250
80284,Novi Sad-grad,105,,1581,760,1567,821,821,3,818,472,346
80284,Novi Sad-grad,106,,1484,593,1484,891,891,8,883,458,425
80284,Novi Sad-grad,107,,1649,662,1651,987,986,10,976,430,546
80284,Novi Sad-grad,108,,1254,665,1254,589,589,11,578,352,226
80284,Novi Sad-grad,109,,1200,620,1202,580,580,6,574,419,155
80284,Novi Sad-grad,110,,1920,1035,1920,885,885,5,880,618,262
80284,Novi Sad-grad,111,,1646,737,1646,909,909,6,903,314,589
80284,Novi Sad-grad,112,,1742,794,1742,948,948,8,940,342,598
80284,Novi Sad-grad,113,,1008,468,1010,540,540,8,532,207,325
80284,Novi Sad-grad,114,,1272,576,1269,696,696,6,690,208,482
80284,Novi Sad-grad,115,,1307,592,1305,715,715,4,711,246,465
80284,Novi Sad-grad,116,,1942,823,1941,1119,1119,17,1102,406,696
80284,Novi Sad-grad,117,,1235,575,1235,660,660,6,654,263,391
80284,Novi Sad-grad,118,,1709,853,1709,856,856,12,844,344,500
80284,Novi Sad-grad,119,,1739,794,1739,945,945,9,936,330,606
80284,Novi Sad-grad,120,,1747,782,1746,965,965,13,952,213,739
80284,Novi Sad-grad,121,,1236,554,1236,682,682,4,678,165,513
80284,Novi Sad-grad,122,,1664,619,1664,1045,1044,13,1031,281,750
80284,Novi Sad-grad,123,,1641,621,1643,1020,1020,9,1011,213,798
80284,Novi Sad-grad,124,,1646,692,1649,954,954,12,942,336,606
80284,Novi Sad-grad,125,,1350,552,1350,798,798,6,792,196,596
80284,Novi Sad-grad,126,,1526,620,1526,906,906,11,895,332,563
80284,Novi Sad-grad,127,,1377,562,1376,815,815,5,810,203,607
80284,Novi Sad-grad,128,,2111,812,2111,1299,1299,10,1289,313,976
80284,Novi Sad-grad,129,,721,273,721,448,448,4,444,100,344
80284,Novi Sad-grad,130,,524,209,523,315,315,4,311,140,171
80284,Novi Sad-grad,131,,1591,661,1591,930,930,13,917,260,657
80284,Novi Sad-grad,132,,1904,864,1903,1040,1040,12,1028,374,654
80284,Novi Sad-grad,133,,1688,757,1688,931,930,13,917,297,620
80284,Novi Sad-grad,134,,1970,865,1972,1105,1104,12,1092,370,722
80284,Novi Sad-grad,135,,1791,797,1790,994,994,8,986,297,689
80284,Novi Sad-grad,136,,1550,711,1548,839,838,3,835,253,582
80284,Novi Sad-grad,137,,1937,870,1939,1067,1067,18,1049,365,684
80284,Novi Sad-grad,138,,1572,630,1658,942,941,14,927,323,604
80284,Novi Sad-grad,139,,1849,883,1854,966,966,10,956,404,552
80284,Novi Sad-grad,140,,1923,893,1923,1030,1029,15,1014,464,550
80284,Novi Sad-grad,141,,1078,496,1079,582,582,3,579,365,214
80284,Novi Sad-grad,142,,1920,837,1921,1083,1083,12,1071,494,577
80284,Novi Sad-grad,143,,1984,950,1986,1034,1034,5,1029,461,568
80284,Novi Sad-grad,144,,1313,621,1306,692,692,10,682,388,294
80284,Novi Sad-grad,145,,651,235,649,416,416,3,413,324,89
80284,Novi Sad-grad,146,,1867,903,1865,964,964,13,951,623,328
80284,Novi Sad-grad,147,,1044,471,1046,573,573,9,564,446,118
80284,Novi Sad-grad,148,,2298,954,2295,1344,1343,15,1328,468,860
80284,Novi Sad-grad,149,,2398,1050,2388,1348,1348,18,1330,408,922
80284,Novi Sad-grad,150,,2126,1066,2128,1060,1060,9,1051,303,748
80284,Novi Sad-grad,151,,2143,985,2143,1158,1158,18,1140,319,821
80284,Novi Sad-grad,152,,1694,850,1695,844,843,5,838,283,555
80284,Novi Sad-grad,153,,1715,874,1714,841,841,12,829,260,569
80284,Novi Sad-grad,154,,821,363,825,458,458,8,450,134,316
80284,Novi Sad-grad,155,,640,290,640,350,350,3,347,135,212
80284,Novi Sad-grad,156,,1502,699,1504,803,803,10,793,253,540
80284,Novi Sad-grad,157,,1571,708,1568,863,863,9,854,272,582
80284,Novi Sad-grad,158,,1701,937,1692,764,764,7,757,266,491
80284,Novi Sad-grad,159,,1110,515,1111,595,595,1,594,189,405
80284,Novi Sad-grad,160,,1292,670,1289,622,622,3,619,195,424
80284,Novi Sad-grad,161,,1645,734,1645,911,911,6,905,294,611
80284,Novi Sad-grad,162,,1710,754,1708,956,955,7,948,225,723
80284,Novi Sad-grad,163,,1627,892,1624,735,735,10,725,253,472
80284,Novi Sad-grad,164,,1442,745,1436,697,697,3,694,286,408
80284,Novi Sad-grad,165,,1422,797,1423,625,625,4,621,234,387
80284,Novi Sad-grad,166,,1736,819,1738,917,917,7,910,290,620
80284,Novi Sad-grad,167,,1905,776,1906,1129,1129,12,1117,407,710
80284,Novi Sad-grad,168,,942,409,943,533,533,8,525,145,380
80284,Novi Sad-grad,169,,1573,759,1573,814,813,8,805,301,504
80284,Novi Sad-grad,170,,1556,708,1556,848,847,10,837,297,540
80284,Novi Sad-grad,171,,1495,816,1496,679,679,7,672,239,433
80284,Novi Sad-grad,172,,1545,924,1533,621,621,8,613,189,424
80284,Novi Sad-grad,173,,1697,754,1696,943,943,12,931,351,580
80284,Novi Sad-grad,174,,1152,604,1151,548,548,5,543,145,398
80292,Opovo,1,,313,155,313,158,158,0,158,74,84
80292,Opovo,2,,295,160,295,135,135,1,134,40,94
80292,Opovo,3,,334,200,334,134,134,2,132,50,82
80292,Opovo,4,,268,159,268,109,109,2,107,57,50
80292,Opovo,5,,376,178,376,198,198,2,196,77,119
80292,Opovo,6,,377,174,377,203,203,3,200,65,135
80292,Opovo,7,,371,195,371,176,176,3,173,70,103
80292,Opovo,8,,485,227,486,258,258,6,252,105,147
80292,Opovo,9,,269,151,269,118,118,3,115,56,59
80292,Opovo,10,,293,117,293,176,176,0,176,91,85
80292,Opovo,11,,361,198,361,163,163,3,160,72,88
80292,Opovo,12,,389,183,389,206,206,3,203,60,143
80292,Opovo,13,,388,153,388,235,235,4,231,153,78
80292,Opovo,14,,353,179,353,174,174,4,170,91,79
80292,Opovo,15,,266,163,266,103,103,1,102,52,50
80292,Opovo,16,,260,143,260,117,117,2,115,52,63
80292,Opovo,17,,335,191,335,144,144,3,141,90,51
80292,Opovo,18,,351,202,351,149,149,5,144,94,50
80292,Opovo,19,,315,175,315,140,140,1,139,72,67
80292,Opovo,20,,367,226,367,141,140,3,137,77,60
80292,Opovo,21,,358,216,358,142,141,1,140,65,75
80292,Opovo,22,,390,240,390,150,150,5,145,86,59
80292,Opovo,23,,370,187,370,183,183,3,180,110,70
80292,Opovo,24,,329,174,329,155,155,1,154,96,58
80292,Opovo,25,,237,112,237,125,125,1,124,70,54
80306,Oxaci,1,,565,319,565,246,246,0,246,165,81
80306,Oxaci,2,,823,481,823,342,342,7,335,259,76
80306,Oxaci,3,,650,375,650,275,275,1,274,212,62
80306,Oxaci,4,,613,334,613,279,279,4,275,193,82
80306,Oxaci,5,,541,287,541,254,254,9,245,188,57
80306,Oxaci,6,,523,274,523,249,249,6,243,193,50
80306,Oxaci,7,,507,254,507,253,253,5,248,178,70
80306,Oxaci,8,,528,240,528,288,288,5,283,207,76
80306,Oxaci,9,,883,543,883,340,340,5,335,41,294
80306,Oxaci,10,,862,423,862,439,439,4,435,53,382
80306,Oxaci,11,,608,282,608,326,326,4,322,227,95
80306,Oxaci,12,,562,293,562,269,269,4,265,186,79
80306,Oxaci,13,,531,316,531,215,215,5,210,166,44
80306,Oxaci,14,,628,354,628,274,274,3,271,206,65
80306,Oxaci,15,,643,277,643,366,366,3,363,272,91
80306,Oxaci,16,,645,327,645,318,318,4,314,267,47
80306,Oxaci,17,,567,289,567,278,278,3,275,217,58
80306,Oxaci,18,,599,315,599,284,284,2,282,238,44
80306,Oxaci,19,,542,240,542,302,302,2,300,226,74
80306,Oxaci,20,,653,267,653,386,386,5,381,309,72
80306,Oxaci,21,,511,257,511,254,254,1,253,164,89
80306,Oxaci,22,,597,265,597,332,332,4,328,234,94
80306,Oxaci,23,,593,319,593,274,274,2,272,175,97
80306,Oxaci,24,,662,295,662,367,367,4,363,257,106
80306,Oxaci,25,,540,241,540,299,299,2,297,175,122
80306,Oxaci,26,,667,324,667,343,343,2,341,225,116
80306,Oxaci,27,,609,281,609,328,328,2,326,222,104
80306,Oxaci,28,,600,290,600,310,310,4,306,193,113
80306,Oxaci,29,,559,267,559,292,292,2,290,178,112
80306,Oxaci,30,,615,258,615,357,357,2,355,185,170
80306,Oxaci,31,,567,258,567,309,309,3,306,164,142
80306,Oxaci,32,,680,301,680,379,379,2,377,229,148
80306,Oxaci,33,,595,308,595,287,287,5,282,165,117
80306,Oxaci,34,,565,228,565,337,337,1,336,145,191
80306,Oxaci,35,,736,364,736,372,372,3,369,195,174
80306,Oxaci,36,,764,349,764,415,415,10,405,238,167
80306,Oxaci,37,,691,298,691,393,393,2,391,232,159
80306,Oxaci,38,,674,339,674,335,335,2,333,204,129
80306,Oxaci,39,,645,325,645,320,320,1,319,189,130
80306,Oxaci,40,,730,312,730,418,418,6,412,205,207
80306,Oxaci,41,,608,285,608,323,323,8,315,77,238
80306,Oxaci,42,,662,287,662,375,375,5,370,195,175
80306,Oxaci,43,,702,392,702,310,310,4,306,200,106
80306,Oxaci,44,,749,357,749,392,392,4,388,206,182
80306,Oxaci,45,,699,331,699,368,368,3,365,219,146
80314,Pančevo,1,,1547,913,1547,634,634,4,630,319,311
80314,Pančevo,2,,1396,736,1396,660,660,2,658,410,248
80314,Pančevo,3,,1424,770,1424,654,654,5,649,292,357
80314,Pančevo,4,,1681,884,1681,797,797,5,792,373,419
80314,Pančevo,5,,1795,1105,1795,690,690,4,686,311,375
80314,Pančevo,6,,1374,707,1374,667,666,8,658,296,362
80314,Pančevo,7,,1800,1024,1800,776,776,3,773,418,355
80314,Pančevo,8,,1236,768,1236,468,468,4,464,265,199
80314,Pančevo,9,,948,591,948,357,357,7,350,204,146
80314,Pančevo,10,,1445,991,1445,454,452,5,447,255,192
80314,Pančevo,11,,1549,873,1549,676,676,10,666,472,194
80314,Pančevo,12,,1265,665,1265,600,600,3,597,355,242
80314,Pančevo,13,,1224,651,1224,573,571,14,557,89,468
80314,Pančevo,14,,1452,789,1452,663,663,6,657,505,152
80314,Pančevo,15,,1867,837,1867,1030,1030,15,1015,622,393
80314,Pančevo,16,,1746,847,1746,899,899,15,884,547,337
80314,Pančevo,17,,1577,813,1577,764,764,8,756,421,335
80314,Pančevo,18,,1563,840,1564,723,719,12,707,447,260
80314,Pančevo,19,,1838,919,1838,919,919,11,908,562,346
80314,Pančevo,20,,1504,782,1506,722,722,12,710,396,314
80314,Pančevo,21,,1502,829,1602,673,673,5,668,270,398
80314,Pančevo,22,,1504,884,1504,620,620,7,613,319,294
80314,Pančevo,23,,1229,622,1229,607,607,8,599,320,279
80314,Pančevo,24,,1320,745,1320,575,575,6,569,373,196
80314,Pančevo,25,,1668,875,1669,793,793,10,783,438,345
80314,Pančevo,26,,1710,880,1710,830,830,8,822,376,446
80314,Pančevo,27,,1887,1041,1888,846,846,13,833,459,374
80314,Pančevo,28,,1144,571,1144,573,573,7,566,396,170
80314,Pančevo,29,,2315,1377,2315,938,938,10,928,480,448
80314,Pančevo,30,,2165,1034,2165,1131,1131,26,1105,408,697
80314,Pančevo,31,,2116,873,2117,1243,1243,15,1228,361,867
80314,Pančevo,32,,1562,755,1566,807,807,14,793,293,500
80314,Pančevo,33,,2106,1059,2106,1047,1047,12,1035,298,737
80314,Pančevo,34,,292,138,292,154,154,6,148,82,66
80314,Pančevo,35,,1284,634,1284,650,650,5,645,203,442
80314,Pančevo,36,,1248,541,1248,707,707,8,699,235,464
80314,Pančevo,37,,1439,668,1440,771,771,11,760,261,499
80314,Pančevo,38,,1228,611,1226,617,617,12,605,191,414
80314,Pančevo,39,,2045,908,2045,1137,1137,21,1116,383,733
80314,Pančevo,40,,1575,758,1575,817,817,11,806,337,469
80314,Pančevo,41,,2141,1066,2141,1075,1075,13,1062,455,607
80314,Pančevo,42,,1593,767,1593,826,826,9,817,332,485
80314,Pančevo,43,,1320,624,1325,696,696,7,689,317,372
80314,Pančevo,44,,1316,584,1316,732,732,9,723,330,393
80314,Pančevo,45,,1454,710,1454,744,744,14,730,277,453
80314,Pančevo,46,,988,524,988,464,464,5,459,192,267
80314,Pančevo,47,,1763,817,1763,946,946,17,929,319,610
80314,Pančevo,48,,1623,783,1623,840,840,14,826,304,522
80314,Pančevo,49,,1641,827,1641,814,814,9,805,278,527
80314,Pančevo,50,,1569,725,1569,844,844,10,834,316,518
80314,Pančevo,51,,1600,743,1600,857,857,9,848,297,551
80314,Pančevo,52,,2050,1086,2050,964,964,17,947,535,412
80314,Pančevo,53,,2415,1151,2416,1264,1264,17,1247,583,664
80314,Pančevo,54,,2353,1094,2355,1259,1259,14,1245,463,782
80314,Pančevo,55,,1921,971,1921,950,945,14,931,543,388
80314,Pančevo,56,,777,343,777,434,434,11,423,109,314
80314,Pančevo,57,,1405,704,1406,701,701,8,693,193,500
80314,Pančevo,58,,1858,910,1860,948,948,6,942,321,621
80314,Pančevo,59,,1669,878,1670,791,790,13,777,218,559
80314,Pančevo,60,,1394,690,1393,704,704,6,698,148,550
80314,Pančevo,61,,1864,969,1865,895,894,8,886,314,572
80314,Pančevo,62,,1788,1034,1788,754,754,9,745,322,423
80314,Pančevo,63,,1319,748,1319,571,571,8,563,272,291
80314,Pančevo,64,,1451,692,1451,759,759,14,745,231,514
80314,Pančevo,65,,1479,725,1479,754,754,7,747,229,518
80314,Pančevo,66,,1212,563,1213,649,649,8,641,193,448
80314,Pančevo,67,,1551,716,1552,835,835,8,827,188,639
80314,Pančevo,68,,2453,1288,2454,1165,1165,16,1149,357,792
80314,Pančevo,69,,2174,1182,2174,992,992,10,982,243,739
80314,Pančevo,70,,559,212,569,347,347,1,346,180,166
80322,Pećinci,1,,529,288,529,241,241,5,236,123,113
80322,Pećinci,2,,509,269,509,240,240,5,235,160,75
80322,Pećinci,3,,376,169,376,207,207,2,205,148,57
80322,Pećinci,4,,403,189,403,214,214,1,213,132,81
80322,Pećinci,5,,468,245,468,223,223,2,221,167,54
80322,Pećinci,6,,478,275,478,203,203,1,202,142,60
80322,Pećinci,7,,414,150,414,264,264,0,264,171,93
80322,Pećinci,8,,377,140,377,237,237,3,234,135,99
80322,Pećinci,9,,380,208,380,172,172,6,166,108,58
80322,Pećinci,10,,439,261,439,178,178,5,173,121,52
80322,Pećinci,11,,488,219,488,269,269,6,263,170,93
80322,Pećinci,12,,409,196,409,213,213,1,212,135,77
80322,Pećinci,13,,572,312,572,260,260,1,259,206,53
80322,Pećinci,14,,480,233,480,247,247,0,247,164,83
80322,Pećinci,15,,572,277,572,295,295,5,290,213,77
80322,Pećinci,16,,370,167,370,203,203,3,200,130,70
80322,Pećinci,17,,462,205,462,257,257,3,254,202,52
80322,Pećinci,18,,657,272,657,385,385,7,378,175,203
80322,Pećinci,19,,695,387,695,308,307,4,303,136,167
80322,Pećinci,20,,695,327,695,368,368,8,360,182,178
80322,Pećinci,21,,525,282,525,243,243,5,238,177,61
80322,Pećinci,22,,420,210,420,210,210,3,207,112,95
80322,Pećinci,23,,578,233,579,345,345,7,338,192,146
80322,Pećinci,24,,414,195,414,219,219,4,215,124,91
80322,Pećinci,25,,664,322,664,342,342,6,336,214,122
80322,Pećinci,26,,337,177,337,160,160,0,160,107,53
80322,Pećinci,27,,343,165,343,178,178,2,176,105,71
80322,Pećinci,28,,684,376,684,308,308,5,303,163,140
80322,Pećinci,29,,696,337,696,359,359,2,357,225,132
80322,Pećinci,30,,767,435,767,332,332,3,329,181,148
80349,Plandište,1,,266,73,266,193,193,5,188,125,63
80349,Plandište,2,,579,343,579,236,236,3,233,28,205
80349,Plandište,3,,538,218,538,320,320,2,318,175,143
80349,Plandište,4,,533,233,533,300,300,7,293,174,119
80349,Plandište,5,,594,296,594,298,298,2,296,168,128
80349,Plandište,6,,157,66,157,91,91,1,90,42,48
80349,Plandište,7,,315,125,315,190,190,2,188,16,172
80349,Plandište,8,,464,183,464,281,281,3,278,31,247
80349,Plandište,9,,265,92,265,173,173,7,166,97,69
80349,Plandište,10,,474,232,474,242,242,4,238,110,128
80349,Plandište,11,,399,187,399,212,212,1,211,110,101
80349,Plandište,12,,164,69,164,95,95,4,91,36,55
80349,Plandište,13,,445,160,445,285,285,6,279,167,112
80349,Plandište,14,,474,230,474,244,244,1,243,132,111
80349,Plandište,15,,484,219,484,265,265,4,261,133,128
80349,Plandište,16,,598,263,598,335,335,12,323,150,173
80349,Plandište,17,,451,198,451,253,253,4,249,115,134
80349,Plandište,18,,449,235,449,214,214,5,209,95,114
80349,Plandište,19,,601,307,601,294,294,8,286,140,146
80349,Plandište,20,,447,212,447,235,235,8,227,128,99
80349,Plandište,21,,397,209,397,188,188,4,184,78,106
80349,Plandište,22,,465,202,465,263,263,7,256,64,192
80349,Plandište,23,,574,235,574,339,339,4,335,167,168
80357,Ruma,1,,1488,672,1488,816,816,10,806,402,404
80357,Ruma,2,,1421,707,1412,714,714,12,702,332,370
80357,Ruma,3,,1173,548,1173,625,625,10,615,247,368
80357,Ruma,4,,1190,558,1192,632,632,10,622,282,340
80357,Ruma,5,,1080,492,1080,588,588,10,578,313,265
80357,Ruma,6,,979,385,980,594,594,11,583,265,318
80357,Ruma,7,,884,351,885,533,533,8,525,211,314
80357,Ruma,8,,977,415,978,562,562,9,553,242,311
80357,Ruma,9,,996,458,996,538,538,2,536,214,322
80357,Ruma,10,,1094,545,1094,549,549,6,543,287,256
80357,Ruma,11,,1267,582,1267,685,685,9,676,371,305
80357,Ruma,12,,1425,665,1426,760,760,9,751,421,330
80357,Ruma,13,,1029,506,1031,523,523,5,518,291,227
80357,Ruma,14,,1357,636,1357,721,721,9,712,398,314
80357,Ruma,15,,1314,586,1314,728,728,4,724,377,347
80357,Ruma,16,,1112,504,1112,608,608,10,598,337,261
80357,Ruma,17,,1292,579,1294,713,713,12,701,310,391
80357,Ruma,18,,1036,437,1036,599,599,10,589,276,313
80357,Ruma,19,,1004,512,1005,492,491,4,487,327,160
80357,Ruma,20,,1121,519,1122,602,602,17,585,355,230
80357,Ruma,21,,1103,506,1103,597,597,5,592,414,178
80357,Ruma,22,,1030,469,1030,561,561,5,556,364,192
80357,Ruma,23,,980,486,960,494,494,2,492,302,190
80357,Ruma,24,,1442,655,1442,787,787,8,779,458,321
80357,Ruma,25,,844,355,844,489,489,5,484,269,215
80357,Ruma,26,,893,434,893,459,459,3,456,188,268
80357,Ruma,27,,1026,491,1046,535,535,13,522,293,229
80357,Ruma,28,,1005,446,1005,559,559,3,556,264,292
80357,Ruma,29,,1050,572,1051,478,478,8,470,340,130
80357,Ruma,30,,1093,630,1093,463,463,5,458,310,148
80357,Ruma,31,,1065,491,1066,574,574,5,569,357,212
80357,Ruma,32,,1273,713,1287,560,560,10,550,366,184
80357,Ruma,33,,943,393,943,550,550,4,546,367,179
80357,Ruma,34,,1269,653,1269,616,616,4,612,375,237
80357,Ruma,35,,811,372,811,439,439,3,436,319,117
80357,Ruma,36,,1374,668,1374,706,706,12,694,503,191
80357,Ruma,37,,970,487,970,483,483,1,482,360,122
80357,Ruma,38,,692,354,692,338,338,4,334,240,94
80357,Ruma,39,,1231,521,1231,710,709,11,698,429,269
80357,Ruma,40,,769,400,769,369,369,7,362,219,143
80357,Ruma,41,,651,364,651,287,287,6,281,195,86
80357,Ruma,42,,471,187,471,284,284,1,283,164,119
80357,Ruma,43,,311,167,311,144,144,0,144,111,33
80365,Senta,1,,688,315,688,373,373,4,369,29,340
80365,Senta,2,,619,294,619,325,325,4,321,90,231
80365,Senta,3,,622,246,622,376,376,4,372,73,299
80365,Senta,4,,773,360,773,413,413,7,406,63,343
80365,Senta,5,,896,360,896,536,536,3,533,42,491
80365,Senta,6,,664,298,664,366,366,1,365,12,353
80365,Senta,7,,603,244,604,359,359,1,358,6,352
80365,Senta,8,,951,412,952,539,539,2,537,58,479
80365,Senta,9,,763,417,763,346,346,7,339,12,327
80365,Senta,10,,900,429,900,471,471,2,469,9,460
80365,Senta,11,,678,273,687,405,405,2,403,9,394
80365,Senta,12,,768,376,768,392,391,4,387,6,381
80365,Senta,13,,763,336,769,427,427,0,427,9,418
80365,Senta,14,,744,322,744,422,422,2,420,16,404
80365,Senta,15,,819,359,819,460,459,4,455,44,411
80365,Senta,16,,1026,464,1026,562,562,2,560,33,527
80365,Senta,17,,793,323,793,470,470,5,465,9,456
80365,Senta,18,,810,333,810,477,477,6,471,12,459
80365,Senta,19,,838,376,838,462,462,3,459,47,412
80365,Senta,20,,794,367,794,427,427,8,419,51,368
80365,Senta,21,,852,412,852,440,440,1,439,84,355
80365,Senta,22,,761,327,761,434,434,2,432,98,334
80365,Senta,23,,773,279,773,494,494,5,489,73,416
80365,Senta,24,,750,337,750,413,413,0,413,4,409
80365,Senta,25,,600,295,600,305,305,1,304,3,301
80365,Senta,26,,120,69,120,51,51,0,51,1,50
80365,Senta,27,,605,241,605,364,364,1,363,6,357
80365,Senta,28,,734,323,735,411,411,2,409,14,395
80365,Senta,29,,315,124,315,191,191,0,191,7,184
80365,Senta,30,,452,180,452,272,272,3,269,2,267
80365,Senta,31,,275,104,275,171,171,1,170,3,167
80365,Senta,32,,264,143,264,121,121,2,119,8,111
80373,Sečanj,1,,326,156,326,170,170,3,167,95,72
80373,Sečanj,2,,372,187,372,185,185,4,181,85,96
80373,Sečanj,3,,367,183,367,184,184,5,179,64,115
80373,Sečanj,4,,317,173,317,144,144,2,142,70,72
80373,Sečanj,5,,307,166,307,141,141,1,140,58,82
80373,Sečanj,6,,392,174,392,218,218,1,217,100,117
80373,Sečanj,7,,350,172,350,178,178,6,172,68,104
80373,Sečanj,8,,396,169,396,227,227,4,223,119,104
80373,Sečanj,9,,325,163,325,162,162,1,161,101,60
80373,Sečanj,10,,333,176,333,157,157,1,156,86,70
80373,Sečanj,11,,402,186,402,216,216,1,215,135,80
80373,Sečanj,12,,275,129,275,146,146,1,145,52,93
80373,Sečanj,13,,337,202,337,135,135,2,133,81,52
80373,Sečanj,14,,382,213,382,169,169,0,169,99,70
80373,Sečanj,15,,414,192,414,222,222,3,219,134,85
80373,Sečanj,16,,283,133,283,150,150,1,149,112,37
80373,Sečanj,17,,387,177,387,210,210,2,208,80,128
80373,Sečanj,18,,375,167,375,208,208,1,207,56,151
80373,Sečanj,19,,342,137,342,205,205,0,205,113,92
80373,Sečanj,20,,334,141,334,193,193,2,191,122,69
80373,Sečanj,21,,331,129,331,202,202,0,202,130,72
80373,Sečanj,22,,337,168,337,169,169,0,169,122,47
80373,Sečanj,23,,370,167,370,203,203,0,203,122,81
80373,Sečanj,24,,337,169,337,168,168,2,166,89,77
80373,Sečanj,25,,288,159,288,129,129,1,128,37,91
80373,Sečanj,26,,323,186,323,137,137,4,133,45,88
80373,Sečanj,27,,475,241,475,234,234,3,231,161,70
80373,Sečanj,28,,405,230,405,175,175,1,174,84,90
80373,Sečanj,29,,410,173,410,237,237,3,234,91,143
80373,Sečanj,30,,406,200,406,206,206,2,204,112,92
80373,Sečanj,31,,377,176,377,201,201,1,200,100,100
80373,Sečanj,32,,345,118,345,227,227,5,222,152,70
80373,Sečanj,33,,321,134,321,187,187,5,182,94,88
80373,Sečanj,34,,341,171,341,170,170,2,168,57,111
80373,Sečanj,35,,337,144,337,193,193,0,193,58,135
80373,Sečanj,36,,243,111,243,132,132,3,129,79,50
80381,Sombor,1,,1500,686,1500,814,814,12,802,241,561
80381,Sombor,2,,1173,502,1173,671,671,10,661,276,385
80381,Sombor,3,,125,60,125,65,65,0,65,28,37
80381,Sombor,4,,1395,653,1395,742,742,13,729,306,423
80381,Sombor,5,,1000,434,1001,566,566,3,563,294,269
80381,Sombor,6,,241,127,242,114,114,1,113,85,28
80381,Sombor,7,,1265,592,1265,673,673,6,667,428,239
80381,Sombor,8,,1041,496,1040,545,545,2,543,354,189
80381,Sombor,9,,132,71,132,61,61,0,61,39,22
80381,Sombor,10,,106,74,106,32,32,0,32,25,7
80381,Sombor,11,,1167,533,1167,634,634,7,627,222,405
80381,Sombor,12,,1169,574,1169,595,594,5,589,236,353
80381,Sombor,13,,207,98,207,109,109,2,107,27,80
80381,Sombor,14,,1706,718,1707,988,988,6,982,383,599
80381,Sombor,15,,1132,481,1132,651,651,7,644,256,388
80381,Sombor,16,,196,105,196,91,91,0,91,76,15
80381,Sombor,17,,1352,588,1352,764,764,6,758,238,520
80381,Sombor,18,,1392,601,1392,791,791,17,774,225,549
80381,Sombor,19,,530,219,530,311,311,5,306,81,225
80381,Sombor,20,,255,126,255,129,129,0,129,87,42
80381,Sombor,21,,488,291,488,197,197,3,194,113,81
80381,Sombor,22,,147,69,147,78,78,1,77,18,59
80381,Sombor,23,,1834,829,1834,1005,1005,4,1001,462,539
80381,Sombor,24,,1089,489,1091,600,599,11,588,281,307
80381,Sombor,25,,1247,557,1247,690,690,13,677,279,398
80381,Sombor,26,,1232,542,1234,690,690,12,678,302,376
80381,Sombor,27,,1592,746,1594,846,846,9,837,385,452
80381,Sombor,28,,1195,557,1196,638,638,4,634,255,379
80381,Sombor,29,,924,341,923,583,583,10,573,230,343
80381,Sombor,30,,575,280,575,295,295,3,292,169,123
80381,Sombor,31,,823,388,823,435,435,7,428,146,282
80381,Sombor,32,,754,332,754,422,422,10,412,247,165
80381,Sombor,33,,1443,623,1442,820,820,9,811,299,512
80381,Sombor,34,,948,439,948,509,509,3,506,331,175
80381,Sombor,35,,350,167,350,183,183,0,183,45,138
80381,Sombor,36,,797,345,797,452,452,6,446,154,292
80381,Sombor,37,,514,252,514,262,262,0,262,63,199
80381,Sombor,38,,480,187,480,293,293,0,293,66,227
80381,Sombor,39,,744,325,745,419,419,1,418,166,252
80381,Sombor,40,,1360,571,1360,789,789,7,782,290,492
80381,Sombor,41,,1143,438,1141,705,703,5,698,203,495
80381,Sombor,42,,1081,431,1078,650,650,10,640,230,410
80381,Sombor,43,,1424,636,1426,788,788,9,779,331,448
80381,Sombor,44,,1454,687,1455,767,767,4,763,317,446
80381,Sombor,45,,1107,458,1107,649,649,3,646,212,434
80381,Sombor,46,,900,455,900,445,445,5,440,276,164
80381,Sombor,47,,848,373,847,475,475,0,475,345,130
80381,Sombor,48,,1192,609,1192,583,583,11,572,130,442
80381,Sombor,49,,1031,461,1031,570,567,6,561,56,505
80381,Sombor,50,,1086,495,1086,591,591,5,586,57,529
80381,Sombor,51,,1135,669,1135,466,458,4,454,33,421
80381,Sombor,52,,1257,674,1258,583,583,5,578,110,468
80381,Sombor,53,,1062,541,1062,521,521,3,518,122,396
80381,Sombor,54,,976,488,976,488,488,8,480,50,430
80381,Sombor,55,,1163,599,1163,564,564,5,559,69,490
80381,Sombor,56,,424,208,424,216,216,2,214,158,56
80381,Sombor,57,,1709,729,1710,980,980,12,968,741,227
80381,Sombor,58,,1343,625,1345,718,718,13,705,159,546
80381,Sombor,59,,1235,600,1235,635,635,7,628,436,192
80381,Sombor,60,,1118,598,1118,520,520,6,514,354,160
80381,Sombor,61,,1108,520,1109,588,588,9,579,487,92
80381,Sombor,62,,1149,531,1150,618,617,7,610,456,154
80381,Sombor,63,,1276,625,1275,651,651,8,643,454,189
80381,Sombor,64,,1011,433,1011,578,578,5,573,466,107
80381,Sombor,65,,1035,529,1035,506,506,4,502,324,178
80381,Sombor,66,,1520,687,1520,833,833,4,829,125,704
80381,Sombor,67,,1016,440,1016,576,576,2,574,69,505
80381,Sombor,68,,1258,641,1258,617,616,5,611,389,222
80381,Sombor,69,,1221,662,1221,559,559,8,551,291,260
80381,Sombor,70,,1272,678,1272,594,594,6,588,342,246
80381,Sombor,71,,1451,854,1451,597,597,5,592,359,233
80381,Sombor,72,,1379,824,1379,555,555,5,550,359,191
80381,Sombor,73,,1516,808,1516,708,708,8,700,88,612
80381,Sombor,74,,1357,693,1357,664,664,9,655,278,377
80381,Sombor,75,,964,513,964,451,451,5,446,284,162
80381,Sombor,76,,991,476,1008,515,515,1,514,302,212
80390,Srbobran,1,,510,196,510,314,314,3,311,207,104
80390,Srbobran,2,,517,156,517,361,361,2,359,266,93
80390,Srbobran,3,,483,212,483,271,271,1,270,111,159
80390,Srbobran,4,,438,196,438,242,242,3,239,109,130
80390,Srbobran,5,,462,171,462,291,290,4,286,135,151
80390,Srbobran,6,,467,176,467,291,291,5,286,142,144
80390,Srbobran,7,,496,192,496,304,304,5,299,108,191
80390,Srbobran,8,,456,197,456,259,259,2,257,76,181
80390,Srbobran,9,,457,139,457,318,318,6,312,162,150
80390,Srbobran,10,,432,166,432,266,266,3,263,171,92
80390,Srbobran,11,,511,222,511,289,289,4,285,226,59
80390,Srbobran,12,,513,140,513,373,373,1,372,264,108
80390,Srbobran,13,,432,165,432,267,267,3,264,107,157
80390,Srbobran,14,,459,170,459,289,289,2,287,147,140
80390,Srbobran,15,,472,210,472,262,262,6,256,20,236
80390,Srbobran,16,,463,194,463,269,269,2,267,63,204
80390,Srbobran,17,,500,203,500,297,297,4,293,82,211
80390,Srbobran,18,,507,225,507,282,282,4,278,97,181
80390,Srbobran,19,,477,217,477,260,260,2,258,127,131
80390,Srbobran,20,,527,190,527,337,337,4,333,118,215
80390,Srbobran,21,,466,174,466,292,292,4,288,92,196
80390,Srbobran,22,,484,210,484,274,274,2,272,183,89
80390,Srbobran,23,,485,210,485,275,275,7,268,168,100
80390,Srbobran,24,,488,184,488,304,304,2,302,153,149
80390,Srbobran,25,,499,185,499,314,314,1,313,158,155
80390,Srbobran,26,,512,243,512,269,269,8,261,153,108
80390,Srbobran,27,,495,238,495,257,257,4,253,175,78
80390,Srbobran,28,,466,188,466,278,278,7,271,195,76
80403,Sremska Mitrovica,1,,779,390,779,389,389,3,386,233,153
80403,Sremska Mitrovica,2,,878,465,878,413,413,6,407,307,100
80403,Sremska Mitrovica,3,,1231,679,1232,552,552,8,544,384,160
80403,Sremska Mitrovica,4,,996,519,996,477,477,10,467,275,192
80403,Sremska Mitrovica,5,,1176,593,1176,583,583,7,576,382,194
80403,Sremska Mitrovica,6,,666,234,666,432,432,3,429,252,177
80403,Sremska Mitrovica,7,,545,251,545,294,294,4,290,209,81
80403,Sremska Mitrovica,8,,1586,818,1586,768,768,6,762,470,292
80403,Sremska Mitrovica,9,,1302,606,1302,696,695,9,686,395,291
80403,Sremska Mitrovica,10,,1194,647,1194,547,547,8,539,376,163
80403,Sremska Mitrovica,11,,1244,549,1244,695,695,10,685,459,226
80403,Sremska Mitrovica,12,,1506,715,1508,791,791,8,783,539,244
80403,Sremska Mitrovica,13,,1194,569,1194,625,625,5,620,362,258
80403,Sremska Mitrovica,14,,1189,665,1189,524,524,3,521,308,213
80403,Sremska Mitrovica,15,,1422,717,1422,705,705,12,693,446,247
80403,Sremska Mitrovica,16,,1410,641,1412,769,757,16,741,484,257
80403,Sremska Mitrovica,17,,661,309,661,352,352,9,343,236,107
80403,Sremska Mitrovica,18,,1119,454,1119,665,665,5,660,411,249
80403,Sremska Mitrovica,19,,1393,652,1393,741,741,9,732,453,279
80403,Sremska Mitrovica,20,,1337,666,1337,671,671,4,667,404,263
80403,Sremska Mitrovica,21,,1709,824,1710,885,885,10,875,495,380
80403,Sremska Mitrovica,22,,1153,717,1153,436,436,2,434,267,167
80403,Sremska Mitrovica,23,,820,429,820,391,391,5,386,259,127
80403,Sremska Mitrovica,24,,1407,625,1407,782,782,2,780,422,358
80403,Sremska Mitrovica,25,,543,265,543,278,278,2,276,199,77
80403,Sremska Mitrovica,26,,136,60,136,76,76,2,74,10,64
80403,Sremska Mitrovica,27,,1431,621,1431,810,810,5,805,417,388
80403,Sremska Mitrovica,28,,153,50,153,103,103,4,99,74,25
80403,Sremska Mitrovica,29,,534,266,534,268,268,7,261,161,100
80403,Sremska Mitrovica,30,,1329,657,1329,672,672,12,660,473,187
80403,Sremska Mitrovica,31,,1561,708,1561,853,853,14,839,560,279
80403,Sremska Mitrovica,32,,1727,795,1727,932,932,8,924,606,318
80403,Sremska Mitrovica,33,,1309,542,1309,767,767,7,760,480,280
80403,Sremska Mitrovica,34,,1687,729,1689,958,958,13,945,452,493
80403,Sremska Mitrovica,35,,1492,642,1492,850,849,13,836,346,490
80403,Sremska Mitrovica,36,,1063,453,1063,610,610,12,598,251,347
80403,Sremska Mitrovica,37,,1187,496,1189,691,691,14,677,296,381
80403,Sremska Mitrovica,38,,1138,487,1140,651,651,14,637,323,314
80403,Sremska Mitrovica,39,,1403,604,1403,799,799,2,797,332,465
80403,Sremska Mitrovica,40,,1594,692,1594,902,902,15,887,571,316
80403,Sremska Mitrovica,41,,1283,466,1284,817,817,17,800,244,556
80403,Sremska Mitrovica,42,,1321,541,1322,780,780,15,765,277,488
80403,Sremska Mitrovica,43,,1410,609,1410,801,801,16,785,308,477
80403,Sremska Mitrovica,44,,1349,520,1349,829,829,12,817,350,467
80403,Sremska Mitrovica,45,,1331,505,1333,826,826,9,817,391,426
80403,Sremska Mitrovica,46,,1002,430,1004,572,572,6,566,188,378
80403,Sremska Mitrovica,47,,1336,598,1338,738,738,7,731,242,489
80403,Sremska Mitrovica,48,,2146,1025,2147,1121,1119,10,1109,563,546
80403,Sremska Mitrovica,49,,1672,776,1674,896,895,12,883,616,267
80403,Sremska Mitrovica,50,,1628,716,1629,912,912,15,897,682,215
80403,Sremska Mitrovica,51,,975,359,975,616,616,8,608,241,367
80403,Sremska Mitrovica,52,,993,399,993,594,594,9,585,231,354
80403,Sremska Mitrovica,53,,897,365,897,532,532,3,529,168,361
80403,Sremska Mitrovica,54,,826,316,827,510,510,12,498,197,301
80403,Sremska Mitrovica,55,,851,323,851,528,528,9,519,154,365
80403,Sremska Mitrovica,56,,1378,601,1379,777,777,10,767,271,496
80411,Sremski Karlovci,1,,478,234,478,244,244,4,240,104,136
80411,Sremski Karlovci,2,,782,380,782,402,402,0,402,189,213
80411,Sremski Karlovci,3,,882,410,882,472,472,4,468,322,146
80411,Sremski Karlovci,4,,815,388,815,427,427,2,425,209,216
80411,Sremski Karlovci,5,,799,417,799,382,382,1,381,216,165
80411,Sremski Karlovci,6,,817,389,817,428,428,2,426,210,216
80411,Sremski Karlovci,7,,974,376,974,598,598,3,595,298,297
80411,Sremski Karlovci,8,,745,334,745,411,411,1,410,173,237
80411,Sremski Karlovci,9,,708,359,708,349,349,2,347,170,177
80411,Sremski Karlovci,10,,587,259,587,328,328,5,323,160,163
80420,Stara Pazova,1,,1039,563,1039,476,476,3,473,328,145
80420,Stara Pazova,2,,1049,579,1049,470,470,4,466,273,193
80420,Stara Pazova,3,,1161,591,1161,570,570,11,559,329,230
80420,Stara Pazova,4,,597,328,597,269,269,5,264,166,98
80420,Stara Pazova,5,,853,410,854,443,443,6,437,273,164
80420,Stara Pazova,6,,1034,528,1034,506,506,7,499,339,160
80420,Stara Pazova,7,,1001,486,1001,515,514,7,507,283,224
80420,Stara Pazova,8,,1040,509,1040,531,530,7,523,362,161
80420,Stara Pazova,9,,824,412,824,412,412,3,409,169,240
80420,Stara Pazova,10,,848,398,849,450,450,4,446,232,214
80420,Stara Pazova,11,,655,309,655,346,346,4,342,211,131
80420,Stara Pazova,12,,804,321,804,483,483,10,473,327,146
80420,Stara Pazova,13,,1224,595,1224,629,629,7,622,436,186
80420,Stara Pazova,14,,878,375,878,503,503,4,499,374,125
80420,Stara Pazova,15,,884,346,884,538,538,14,524,278,246
80420,Stara Pazova,16,,1063,454,1063,609,609,14,595,369,226
80420,Stara Pazova,17,,873,412,873,461,461,7,454,309,145
80420,Stara Pazova,18,,977,429,977,548,548,10,538,346,192
80420,Stara Pazova,19,,895,383,895,512,512,8,504,283,221
80420,Stara Pazova,20,,735,306,735,429,429,4,425,245,180
80420,Stara Pazova,21,,982,404,982,578,577,8,569,325,244
80420,Stara Pazova,22,,875,404,875,471,471,13,458,314,144
80420,Stara Pazova,23,,1070,483,1070,587,587,9,578,306,272
80420,Stara Pazova,24,,834,336,834,498,497,8,489,296,193
80420,Stara Pazova,25,,812,355,812,457,457,4,453,267,186
80420,Stara Pazova,26,,1197,552,1197,645,645,9,636,360,276
80420,Stara Pazova,27,,1456,735,1456,721,721,8,713,386,327
80420,Stara Pazova,28,,1340,647,1341,693,693,7,686,432,254
80420,Stara Pazova,29,,1236,560,1236,676,676,6,670,358,312
80420,Stara Pazova,30,,1221,548,1221,673,673,7,666,201,465
80420,Stara Pazova,31,,864,369,864,495,495,8,487,144,343
80420,Stara Pazova,32,,1389,613,1390,776,776,13,763,293,470
80420,Stara Pazova,33,,837,347,837,490,490,11,479,118,361
80420,Stara Pazova,34,,1077,550,1077,527,527,8,519,222,297
80420,Stara Pazova,35,,953,419,954,534,534,7,527,220,307
80420,Stara Pazova,36,,774,314,774,460,460,11,449,126,323
80420,Stara Pazova,37,,765,308,765,457,457,13,444,167,277
80420,Stara Pazova,38,,823,386,823,437,437,7,430,191,239
80420,Stara Pazova,39,,1001,435,1001,566,566,14,552,365,187
80420,Stara Pazova,40,,1155,528,1156,627,626,7,619,376,243
80420,Stara Pazova,41,,785,377,786,408,408,5,403,183,220
80420,Stara Pazova,42,,954,426,954,528,528,6,522,190,332
80420,Stara Pazova,43,,776,325,776,451,451,7,444,169,275
80420,Stara Pazova,44,,911,404,907,507,507,2,505,157,348
80420,Stara Pazova,45,,996,566,996,430,429,2,427,268,159
80420,Stara Pazova,46,,1264,671,1264,593,593,4,589,340,249
80420,Stara Pazova,47,,1338,754,1338,584,584,5,579,333,246
80420,Stara Pazova,48,,948,492,950,456,456,9,447,224,223
80438,Subotica,1,,1485,715,1483,770,770,13,757,225,532
80438,Subotica,2,,1461,716,1461,745,745,12,733,174,559
80438,Subotica,3,,1589,756,1589,833,832,7,825,177,648
80438,Subotica,4,,1427,704,1427,723,723,7,716,112,604
80438,Subotica,5,,712,303,712,409,409,10,399,100,299
80438,Subotica,6,,755,287,755,468,468,3,465,131,334
80438,Subotica,7,,567,233,567,334,334,1,333,122,211
80438,Subotica,8,,585,292,585,293,293,1,292,54,238
80438,Subotica,9,,1137,554,1137,583,583,12,571,113,458
80438,Subotica,10,,306,137,306,169,169,1,168,53,115
80438,Subotica,11,,1573,630,1573,943,943,12,931,266,665
80438,Subotica,12,,1803,754,1803,1049,1049,10,1039,295,744
80438,Subotica,13,,1763,762,1763,1001,1001,9,992,216,776
80438,Subotica,14,,2124,922,2124,1202,1202,16,1186,333,853
80438,Subotica,15,,1987,898,1987,1089,1089,12,1077,186,891
80438,Subotica,16,,1876,934,1876,942,942,4,938,108,830
80438,Subotica,17,,1073,490,1073,583,583,2,581,115,466
80438,Subotica,18,,1279,644,1279,635,635,6,629,90,539
80438,Subotica,19,,1268,545,1268,723,723,12,711,125,586
80438,Subotica,20,,1142,497,1142,645,645,5,640,97,543
80438,Subotica,21,,1543,759,1543,784,784,10,774,135,639
80438,Subotica,22,,1002,456,1002,546,546,2,544,61,483
80438,Subotica,23,,1338,557,1338,781,781,8,773,70,703
80438,Subotica,24,,1553,723,1553,830,830,6,824,151,673
80438,Subotica,25,,2043,951,2043,1092,1091,12,1079,172,907
80438,Subotica,26,,1003,454,1003,549,549,8,541,72,469
80438,Subotica,27,,1110,472,1110,638,638,8,630,109,521
80438,Subotica,28,,2386,985,2386,1401,1401,22,1379,338,1041
80438,Subotica,29,,1934,779,1934,1155,1155,14,1141,249,892
80438,Subotica,30,,287,131,287,156,156,4,152,31,121
80438,Subotica,31,,1850,800,1850,1050,1050,14,1036,178,858
80438,Subotica,32,,1868,877,1868,991,991,11,980,232,748
80438,Subotica,33,,804,294,804,510,510,8,502,96,406
80438,Subotica,34,,857,350,857,507,507,5,502,115,387
80438,Subotica,35,,1049,378,1049,671,668,9,659,190,469
80438,Subotica,36,,750,306,750,444,444,6,438,103,335
80438,Subotica,37,,1886,831,1886,1055,1054,14,1040,412,628
80438,Subotica,38,,2367,970,2367,1397,1397,4,1393,571,822
80438,Subotica,39,,783,270,783,513,513,2,511,161,350
80438,Subotica,40,,1908,824,1908,1084,1084,8,1076,418,658
80438,Subotica,41,,1056,461,1056,595,595,4,591,246,345
80438,Subotica,42,,866,338,866,528,528,6,522,102,420
80438,Subotica,43,,1060,440,1060,620,620,7,613,111,502
80438,Subotica,44,,574,237,574,337,337,1,336,66,270
80438,Subotica,45,,1095,539,1095,556,556,6,550,177,373
80438,Subotica,46,,610,266,610,344,344,5,339,99,240
80438,Subotica,47,,1003,442,1003,561,561,8,553,204,349
80438,Subotica,48,,815,298,815,517,517,6,511,145,366
80438,Subotica,49,,238,124,238,114,114,0,114,20,94
80438,Subotica,50,,1483,589,1452,894,894,23,871,277,594
80438,Subotica,51,,837,346,837,491,491,4,487,170,317
80438,Subotica,52,,316,120,316,196,196,2,194,25,169
80438,Subotica,53,,274,125,274,149,149,5,144,37,107
80438,Subotica,54,,1453,575,1453,878,878,4,874,144,730
80438,Subotica,55,,1349,549,1349,800,800,4,796,120,676
80438,Subotica,56,,2240,965,2240,1275,1275,10,1265,317,948
80438,Subotica,57,,2441,1055,2441,1386,1386,14,1372,338,1034
80438,Subotica,58,,2449,1037,2449,1412,1412,11,1401,343,1058
80438,Subotica,59,,1624,668,1624,956,956,5,951,174,777
80438,Subotica,60,,1692,681,1692,1011,1008,8,1000,164,836
80438,Subotica,61,,1818,780,1818,1038,1035,14,1021,140,881
80438,Subotica,62,,2010,962,2010,1048,1039,11,1028,240,788
80438,Subotica,63,,1834,921,1834,913,913,9,904,191,713
80438,Subotica,64,,2245,792,2245,1453,1453,23,1430,245,1185
80438,Subotica,65,,2364,854,2364,1510,1507,22,1485,272,1213
80438,Subotica,66,,1361,533,1361,828,828,7,821,75,746
80438,Subotica,67,,426,174,426,252,252,3,249,13,236
80438,Subotica,68,,2398,1009,2398,1389,1389,11,1378,185,1193
80438,Subotica,69,,2339,1004,2339,1335,1333,12,1321,164,1157
80438,Subotica,70,,1915,770,1912,1145,1145,16,1129,138,991
80438,Subotica,71,,1367,513,1367,854,854,4,850,31,819
80438,Subotica,72,,342,95,342,247,247,1,246,4,242
80438,Subotica,73,,536,262,536,274,274,0,274,21,253
80438,Subotica,74,,385,184,385,201,201,4,197,6,191
80438,Subotica,75,,1367,515,1367,852,852,3,849,30,819
80438,Subotica,76,,331,147,331,184,184,1,183,6,177
80438,Subotica,77,,365,146,365,219,219,1,218,8,210
80438,Subotica,78,,312,99,312,213,213,5,208,9,199
80438,Subotica,79,,1205,536,1205,669,669,4,665,279,386
80438,Subotica,80,,1974,841,1974,1133,1133,11,1122,35,1087
80438,Subotica,81,,1989,694,1989,1295,1295,7,1288,31,1257
80438,Subotica,82,,1957,843,1957,1114,1112,21,1091,35,1056
80438,Subotica,83,,483,181,483,302,302,6,296,151,145
80438,Subotica,84,,552,175,552,377,377,4,373,118,255
80438,Subotica,85,,1153,424,1153,729,729,7,722,524,198
80438,Subotica,86,,980,504,980,476,476,11,465,260,205
80438,Subotica,87,,1774,713,1774,1061,1061,23,1038,169,869
80438,Subotica,88,,1408,539,1408,869,869,10,859,234,625
80438,Subotica,89,,2326,1128,2326,1198,1198,13,1185,208,977
80438,Subotica,90,,1685,835,1685,850,850,6,844,377,467
80438,Subotica,91,,524,265,524,259,259,2,257,41,216
80438,Subotica,92,,1093,524,1093,569,569,10,559,163,396
80438,Subotica,93,,1230,603,1230,627,627,4,623,263,360
80438,Subotica,94,,347,169,347,178,178,1,177,103,74
80438,Subotica,95,,1051,469,1051,582,582,11,571,105,466
80438,Subotica,96,,343,177,343,166,166,1,165,57,108
80438,Subotica,97,,807,405,807,402,402,2,400,82,318
80438,Subotica,98,,793,330,793,463,463,9,454,68,386
80438,Subotica,99,,174,95,174,79,79,1,78,11,67
80438,Subotica,100,,633,351,633,282,282,3,279,51,228
80438,Subotica,101,,182,117,182,65,65,0,65,11,54
80438,Subotica,102,,320,156,320,164,164,3,161,22,139
80438,Subotica,103,,155,104,155,51,51,1,50,6,44
80438,Subotica,104,,885,421,885,464,464,6,458,117,341
80438,Subotica,105,,834,375,834,459,459,3,456,67,389
80438,Subotica,106,,948,403,948,545,545,3,542,95,447
80446,Temerin,1,,608,221,608,387,387,4,383,298,85
80446,Temerin,2,,620,199,621,421,421,4,417,304,113
80446,Temerin,3,,666,250,666,416,416,3,413,318,95
80446,Temerin,4,,353,124,353,229,229,4,225,179,46
80446,Temerin,5,,561,239,561,322,322,5,317,229,88
80446,Temerin,6,,553,211,553,342,342,5,337,233,104
80446,Temerin,7,,638,233,638,405,405,4,401,282,119
80446,Temerin,8,,592,259,592,333,333,2,331,229,102
80446,Temerin,9,,737,222,737,515,515,4,511,415,96
80446,Temerin,10,,605,196,606,409,409,4,405,315,90
80446,Temerin,11,,686,233,687,453,453,7,446,295,151
80446,Temerin,12,,646,254,646,392,391,2,389,278,111
80446,Temerin,13,,695,251,695,444,444,1,443,315,128
80446,Temerin,14,,550,203,550,347,347,0,347,45,302
80446,Temerin,15,,448,180,449,268,268,0,268,31,237
80446,Temerin,16,,838,264,839,574,574,3,571,134,437
80446,Temerin,17,,787,251,788,536,536,0,536,61,475
80446,Temerin,18,,883,312,883,571,571,2,569,87,482
80446,Temerin,19,,641,206,641,435,435,1,434,45,389
80446,Temerin,20,,838,285,838,553,553,4,549,122,427
80446,Temerin,21,,948,321,948,627,627,10,617,311,306
80446,Temerin,22,,986,299,986,687,687,2,685,75,610
80446,Temerin,23,,703,241,703,462,462,2,460,125,335
80446,Temerin,24,,692,188,693,504,504,1,503,200,303
80446,Temerin,25,,746,254,746,492,492,2,490,112,378
80446,Temerin,26,,1225,385,1225,840,840,16,824,273,551
80446,Temerin,27,,481,162,481,319,319,2,317,19,298
80446,Temerin,28,,1024,374,1024,650,650,2,648,368,280
80446,Temerin,29,,622,232,622,390,390,5,385,271,114
80446,Temerin,30,,742,280,742,462,462,6,456,340,116
80446,Temerin,31,,866,383,866,483,483,3,480,342,138
80454,Titel,1,,550,190,550,360,360,7,353,133,220
80454,Titel,2,,581,230,581,351,351,4,347,173,174
80454,Titel,3,,529,204,529,325,325,3,322,155,167
80454,Titel,4,,538,226,538,312,312,4,308,126,182
80454,Titel,5,,494,224,494,270,270,4,266,129,137
80454,Titel,6,,484,199,484,285,285,7,278,157,121
80454,Titel,7,,464,190,464,274,274,3,271,152,119
80454,Titel,8,,511,233,510,278,278,2,276,176,100
80454,Titel,9,,472,199,472,273,273,1,272,169,103
80454,Titel,10,,390,185,390,205,205,2,203,108,95
80454,Titel,11,,496,216,496,280,280,2,278,108,170
80454,Titel,12,,298,129,298,169,169,0,169,77,92
80454,Titel,13,,419,205,419,214,214,1,213,129,84
80454,Titel,14,,516,233,516,283,283,4,279,130,149
80454,Titel,15,,489,214,489,275,275,1,274,189,85
80454,Titel,16,,459,209,459,250,250,0,250,182,68
80454,Titel,17,,444,212,444,232,232,2,230,151,79
80454,Titel,18,,682,312,682,370,370,1,369,300,69
80454,Titel,19,,402,155,402,247,247,2,245,163,82
80454,Titel,20,,476,209,476,267,267,1,266,192,74
80454,Titel,21,,439,187,439,252,252,0,252,195,57
80454,Titel,22,,396,171,396,225,225,2,223,117,106
80454,Titel,23,,401,191,401,210,210,0,210,132,78
80454,Titel,24,,484,237,484,247,247,3,244,181,63
80454,Titel,25,,419,146,419,273,273,1,272,222,50
80462,Vrbas,1,,1122,488,1122,634,634,5,629,358,271
80462,Vrbas,2,,1054,450,1054,604,604,13,591,327,264
80462,Vrbas,3,,1146,477,1146,669,669,10,659,362,297
80462,Vrbas,4,,1093,480,1093,613,613,12,601,389,212
80462,Vrbas,5,,1097,520,1097,577,577,9,568,371,197
80462,Vrbas,6,,1326,606,1326,720,720,14,706,467,239
80462,Vrbas,7,,1045,466,1045,579,579,7,572,330,242
80462,Vrbas,8,,1300,604,1300,696,696,10,686,321,365
80462,Vrbas,9,,1113,511,1113,602,602,14,588,324,264
80462,Vrbas,10,,1116,435,1116,681,681,14,667,342,325
80462,Vrbas,11,,989,440,989,549,549,7,542,286,256
80462,Vrbas,12,,1080,467,1080,613,613,13,600,360,240
80462,Vrbas,13,,1120,443,1120,677,677,14,663,341,322
80462,Vrbas,14,,1072,425,1072,647,647,14,633,336,297
80462,Vrbas,15,,1143,527,1143,616,616,12,604,364,240
80462,Vrbas,16,,1086,442,1086,644,643,17,626,350,276
80462,Vrbas,17,,1086,562,1086,524,524,8,516,294,222
80462,Vrbas,18,,1160,493,1160,667,667,18,649,405,244
80462,Vrbas,19,,986,392,986,594,594,6,588,351,237
80462,Vrbas,20,,947,404,947,543,543,6,537,397,140
80462,Vrbas,21,,1063,407,1063,656,656,6,650,455,195
80462,Vrbas,22,,997,386,997,611,611,5,606,417,189
80462,Vrbas,23,,806,382,807,424,424,4,420,260,160
80462,Vrbas,24,,858,418,858,440,440,4,436,302,134
80462,Vrbas,25,,833,395,833,438,438,4,434,264,170
80462,Vrbas,26,,791,376,791,415,415,3,412,239,173
80462,Vrbas,27,,838,391,838,447,447,4,443,174,269
80462,Vrbas,28,,884,349,884,535,535,10,525,167,358
80462,Vrbas,29,,881,326,881,555,554,7,547,261,286
80462,Vrbas,30,,894,373,895,521,521,10,511,335,176
80462,Vrbas,31,,920,372,980,548,548,8,540,404,136
80462,Vrbas,32,,926,393,927,533,533,4,529,395,134
80462,Vrbas,33,,885,409,885,476,476,4,472,326,146
80462,Vrbas,34,,867,353,867,514,514,4,510,405,105
80462,Vrbas,35,,875,385,875,490,490,5,485,359,126
80462,Vrbas,36,,817,363,817,454,454,9,445,312,133
80489,Čoka,1,,312,143,312,169,169,3,166,3,163
80489,Čoka,2,,356,191,356,165,165,1,164,7,157
80489,Čoka,3,,362,208,362,154,154,4,150,16,134
80489,Čoka,4,,377,194,377,183,183,5,178,67,111
80489,Čoka,5,,352,166,352,186,186,3,183,101,82
80489,Čoka,6,,362,161,362,201,201,3,198,125,73
80489,Čoka,7,,344,133,343,211,211,4,207,133,74
80489,Čoka,8,,372,146,372,226,226,3,223,106,117
80489,Čoka,9,,322,145,322,177,177,2,175,129,46
80489,Čoka,10,,379,203,379,176,176,0,176,50,126
80489,Čoka,11,,395,193,395,202,202,4,198,44,154
80489,Čoka,12,,389,187,389,202,202,1,201,76,125
80489,Čoka,13,,336,162,336,174,174,1,173,49,124
80489,Čoka,14,,353,180,353,173,173,1,172,36,136
80489,Čoka,15,,377,199,377,178,178,2,176,25,151
80489,Čoka,16,,335,165,335,170,170,4,166,120,46
80489,Čoka,17,,329,130,329,199,199,4,195,139,56
80489,Čoka,18,,320,159,320,161,161,2,159,109,50
80489,Čoka,19,,128,46,129,82,82,0,82,17,65
80489,Čoka,20,,285,115,285,170,170,0,170,75,95
80489,Čoka,21,,481,176,481,305,305,2,303,37,266
80489,Čoka,22,,384,145,385,239,239,1,238,34,204
80489,Čoka,23,,327,127,327,200,200,3,197,80,117
80489,Čoka,24,,423,146,423,277,277,6,271,106,165
80489,Čoka,25,,164,62,164,102,102,1,101,44,57
80489,Čoka,26,,226,74,226,152,152,2,150,47,103
80489,Čoka,27,,392,165,392,227,227,4,223,53,170
80489,Čoka,28,,362,124,362,238,238,4,234,30,204
80489,Čoka,29,,377,159,377,218,218,2,216,51,165
80489,Čoka,30,,432,172,432,260,260,5,255,28,227
80489,Čoka,31,,356,131,356,225,225,2,223,88,135
80489,Čoka,32,,114,33,114,81,81,0,81,4,77
80497,Šid,1,,910,454,910,456,456,4,452,292,160
80497,Šid,2,,681,343,681,338,338,6,332,230,102
80497,Šid,3,,287,144,287,143,143,1,142,77,65
80497,Šid,4,,997,490,997,507,507,10,497,281,216
80497,Šid,5,,895,484,896,411,411,11,400,212,188
80497,Šid,6,,615,230,615,385,385,9,376,143,233
80497,Šid,7,,232,78,232,154,154,5,149,53,96
80497,Šid,8,,595,335,595,260,260,3,257,169,88
80497,Šid,9,,606,281,605,325,325,9,316,220,96
80497,Šid,10,,617,310,617,307,307,2,305,205,100
80497,Šid,11,,815,405,815,410,410,8,402,257,145
80497,Šid,12,,777,385,777,392,392,3,389,268,121
80497,Šid,13,,801,324,801,477,477,1,476,283,193
80497,Šid,14,,760,294,760,466,466,13,453,101,352
80497,Šid,15,,852,328,853,524,524,8,516,244,272
80497,Šid,16,,673,346,674,327,327,5,322,265,57
80497,Šid,17,,899,587,899,312,312,3,309,205,104
80497,Šid,18,,773,342,774,431,431,7,424,332,92
80497,Šid,19,,727,309,730,418,418,8,410,340,70
80497,Šid,20,,418,192,418,226,226,6,220,62,158
80497,Šid,21,,206,77,206,129,129,1,128,89,39
80497,Šid,22,,613,257,613,356,356,7,349,190,159
80497,Šid,23,,979,460,979,519,519,2,517,320,197
80497,Šid,24,,153,84,153,69,69,0,69,37,32
80497,Šid,25,,534,242,534,292,292,7,285,102,183
80497,Šid,26,,1000,543,1000,457,457,14,443,193,250
80497,Šid,27,,729,351,728,378,378,6,372,164,208
80497,Šid,28,,874,447,874,427,426,6,420,201,219
80497,Šid,29,,1294,662,1294,632,632,8,624,247,377
80497,Šid,30,,754,318,754,436,436,5,431,166,265
80497,Šid,31,,824,403,825,421,421,6,415,163,252
80497,Šid,32,,508,252,508,256,256,2,254,139,115
80497,Šid,33,,758,351,758,407,407,5,402,185,217
80497,Šid,34,,795,398,795,397,397,4,393,207,186
80497,Šid,35,,1194,570,1194,624,624,5,619,345,274
80497,Šid,36,,1280,665,1281,615,615,7,608,273,335
80497,Šid,37,,871,461,870,410,410,13,397,206,191
80497,Šid,38,,1230,679,1235,551,551,9,542,306,236
80497,Šid,39,,637,301,639,336,336,6,330,178,152
90018,Vitina,1,,132,54,132,78,78,2,76,35,41
90018,Vitina,2,,293,118,293,175,175,5,170,123,47
90018,Vitina,3,,726,432,726,294,294,6,288,202,86
90018,Vitina,4,,297,145,297,152,152,4,148,82,66
90018,Vitina,5,,122,42,122,80,80,4,76,47,29
90018,Vitina,6,,536,270,536,266,266,11,255,148,107
90026,Vučitrn,1,,486,252,486,234,234,1,233,203,30
90026,Vučitrn,2,,1267,738,1267,529,529,3,526,401,125
90026,Vučitrn,3,,199,61,198,138,138,1,137,101,36
90026,Vučitrn,4,,232,126,232,106,106,1,105,79,26
90026,Vučitrn,5,,124,64,124,60,60,0,60,53,7
90042,Gnjilane,1,,176,93,176,83,83,2,81,58,23
90042,Gnjilane,2,,104,33,104,71,71,0,71,48,23
90042,Gnjilane,3,,45,14,45,31,31,0,31,17,14
90042,Gnjilane,4,,809,483,809,326,326,0,326,237,89
90042,Gnjilane,5,,395,266,395,129,129,0,129,94,35
90042,Gnjilane,6,,282,157,282,125,125,2,123,74,49
90042,Gnjilane,7,,776,400,776,376,376,5,371,189,182
90042,Gnjilane,8,,249,85,249,164,164,0,164,95,69
90042,Gnjilane,9,,587,399,587,188,188,3,185,122,63
90042,Gnjilane,10,,214,132,214,82,82,0,82,47,35
90042,Gnjilane,11,,114,59,114,55,55,0,55,38,17
90042,Gnjilane,12,,1138,670,1138,468,468,9,459,298,161
90042,Gnjilane,13,,819,518,819,301,301,10,291,207,84
90042,Gnjilane,14,,90,14,90,76,76,0,76,44,32
90042,Gnjilane,15,,979,717,979,262,262,3,259,198,61
90042,Gnjilane,16,,554,378,554,176,176,0,176,111,65
90042,Gnjilane,17,,822,473,822,349,349,4,345,195,150
90042,Gnjilane,18,,254,145,254,109,109,1,108,82,26
90042,Gnjilane,19,,214,115,214,99,99,1,98,69,29
90093,Zubin Potok,1,,427,189,427,238,238,0,238,150,88
90093,Zubin Potok,2,,891,777,891,114,114,2,112,47,65
90093,Zubin Potok,3,,287,186,287,101,101,0,101,58,43
90093,Zubin Potok,4,,333,165,333,168,168,1,167,77,90
90093,Zubin Potok,5,,1152,586,1152,566,566,2,564,322,242
90093,Zubin Potok,6,,202,60,202,142,142,2,140,51,89
90093,Zubin Potok,7,,326,159,326,167,167,0,167,80,87
90093,Zubin Potok,8,,400,246,400,154,154,1,153,91,62
90093,Zubin Potok,9,,180,101,180,79,79,1,78,47,31
90093,Zubin Potok,10,,143,101,143,42,42,0,42,23,19
90093,Zubin Potok,11,,105,58,105,47,47,0,47,24,23
90093,Zubin Potok,12,,107,49,107,58,58,0,58,20,38
90093,Zubin Potok,13,,135,43,135,92,92,0,92,25,67
90093,Zubin Potok,14,,148,47,148,101,101,1,100,40,60
90093,Zubin Potok,15,,139,37,139,102,102,8,94,45,49
90093,Zubin Potok,16,,144,68,144,76,76,0,76,51,25
90093,Zubin Potok,17,,101,47,101,54,54,0,54,35,19
90093,Zubin Potok,18,,190,87,190,103,103,2,101,43,58
90093,Zubin Potok,19,,106,27,106,79,79,0,79,36,43
90093,Zubin Potok,20,,114,25,114,89,89,0,89,34,55
90093,Zubin Potok,21,,101,26,101,75,75,0,75,12,63
90107,Istok,1,,210,113,211,97,97,1,96,54,42
90107,Istok,2,,104,47,104,57,57,1,56,51,5
90131,Kosovo Polje,1,,545,520,545,25,25,0,25,20,5
90131,Kosovo Polje,2,,332,319,332,13,13,0,13,11,2
90131,Kosovo Polje,3,,732,672,732,60,60,0,60,52,8
90131,Kosovo Polje,4,,1127,1113,1127,14,14,0,14,13,1
90131,Kosovo Polje,5,,211,149,211,62,62,0,62,53,9
90131,Kosovo Polje,6,,135,74,135,61,61,0,61,46,15
90131,Kosovo Polje,7,,133,70,133,63,63,2,61,51,10
90131,Kosovo Polje,8,,169,72,169,97,97,2,95,84,11
90131,Kosovo Polje,9,,153,52,153,101,101,2,99,91,8
90131,Kosovo Polje,10,,317,217,317,100,100,4,96,87,9
90131,Kosovo Polje,11,,185,136,185,49,49,0,49,38,11
90131,Kosovo Polje,12,,245,140,245,105,105,0,105,94,11
90131,Kosovo Polje,13,,285,164,285,121,121,0,121,98,23
90131,Kosovo Polje,14,,176,99,176,77,77,2,75,61,14
90131,Kosovo Polje,15,,232,144,232,88,88,0,88,71,17
90140,Kosovska Kamenica,1,,778,326,778,452,452,5,447,345,102
90140,Kosovska Kamenica,2,,569,188,569,381,381,3,378,329,49
90140,Kosovska Kamenica,3,,179,60,179,119,119,0,119,107,12
90140,Kosovska Kamenica,4,,242,103,242,139,139,0,139,78,61
90140,Kosovska Kamenica,5,,329,176,329,153,153,0,153,134,19
90140,Kosovska Kamenica,6,,120,11,120,109,109,7,102,90,12
90140,Kosovska Kamenica,7,,184,86,184,98,98,0,98,72,26
90140,Kosovska Kamenica,8,,171,108,171,63,63,0,63,52,11
90140,Kosovska Kamenica,9,,103,7,103,96,96,0,96,79,17
90140,Kosovska Kamenica,10,,174,55,174,119,119,2,117,65,52
90140,Kosovska Kamenica,11,,138,45,138,93,93,0,93,88,5
90140,Kosovska Kamenica,12,,222,11,222,211,211,2,209,131,78
90140,Kosovska Kamenica,13,,250,9,250,241,241,7,234,180,54
90140,Kosovska Kamenica,14,,465,216,467,249,249,0,249,183,66
90140,Kosovska Kamenica,15,,447,194,447,253,253,5,248,171,77
90140,Kosovska Kamenica,16,,745,345,745,400,400,5,395,265,130
90140,Kosovska Kamenica,17,,349,137,349,212,212,0,212,185,27
90140,Kosovska Kamenica,18,,403,142,403,261,261,0,261,191,70
90140,Kosovska Kamenica,19,,656,315,656,341,341,2,339,239,100
90140,Kosovska Kamenica,20,,107,24,107,83,83,3,80,71,9
90140,Kosovska Kamenica,21,,205,73,205,132,132,2,130,108,22
90140,Kosovska Kamenica,22,,106,4,106,102,102,2,100,77,23
90140,Kosovska Kamenica,23,,174,62,174,112,112,0,112,82,30
90158,Leposavić,1,,594,285,594,309,309,2,307,213,94
90158,Leposavić,2,,546,316,546,230,230,5,225,169,56
90158,Leposavić,3,,813,425,813,388,388,5,383,270,113
90158,Leposavić,4,,648,407,648,241,241,0,241,168,73
90158,Leposavić,5,,566,321,566,245,245,0,245,192,53
90158,Leposavić,6,,334,205,334,129,129,1,128,100,28
90158,Leposavić,7,,155,90,155,65,65,1,64,51,13
90158,Leposavić,8,,206,102,206,104,104,1,103,67,36
90158,Leposavić,9,,133,78,133,55,55,0,55,43,12
90158,Leposavić,10,,305,174,305,131,131,2,129,97,32
90158,Leposavić,11,,260,164,260,96,96,0,96,71,25
90158,Leposavić,12,,783,450,783,333,333,1,332,277,55
90158,Leposavić,13,,290,214,290,76,76,0,76,61,15
90158,Leposavić,14,,105,58,105,47,47,0,47,23,24
90158,Leposavić,15,,289,289,289,0,0,0,0,0,0
90158,Leposavić,16,,241,151,241,90,90,1,89,59,30
90158,Leposavić,17,,445,286,445,159,159,1,158,103,55
90158,Leposavić,18,,267,160,267,107,107,0,107,79,28
90158,Leposavić,19,,183,102,183,81,81,1,80,64,16
90158,Leposavić,20,,202,154,202,48,48,0,48,39,9
90158,Leposavić,21,,604,353,604,251,251,2,249,172,77
90158,Leposavić,22,,806,500,806,306,306,3,303,216,87
90158,Leposavić,23,,374,256,374,118,118,2,116,85,31
90158,Leposavić,24,,127,26,127,101,101,0,101,69,32
90158,Leposavić,25,,123,41,123,82,82,0,82,42,40
90158,Leposavić,26,,279,112,279,167,167,2,165,98,67
90158,Leposavić,27,,209,126,209,83,83,0,83,59,24
90158,Leposavić,28,,226,100,226,126,126,2,124,99,25
90158,Leposavić,29,,414,321,414,93,93,0,93,62,31
90158,Leposavić,30,,412,263,412,149,149,1,148,140,8
90158,Leposavić,31,,169,56,169,113,113,0,113,91,22
90158,Leposavić,32,,200,149,200,51,51,0,51,10,41
90158,Leposavić,33,,506,407,506,99,99,0,99,66,33
90166,Lipljan,1,,455,173,455,282,282,2,280,229,51
90166,Lipljan,2,,348,104,348,244,244,3,241,217,24
90166,Lipljan,3,,366,102,366,264,264,3,261,217,44
90166,Lipljan,4,,409,162,409,247,247,2,245,185,60
90166,Lipljan,5,,452,114,452,338,338,1,337,260,77
90166,Lipljan,6,,308,94,308,214,214,0,214,168,46
90166,Lipljan,7,,267,166,267,101,101,1,100,78,22
90166,Lipljan,8,,174,42,174,132,132,1,131,117,14
90166,Lipljan,9,,194,50,194,144,144,2,142,99,43
90166,Lipljan,10,,282,178,282,104,104,2,102,92,10
90166,Lipljan,11,,454,371,454,83,83,0,83,66,17
90166,Lipljan,12,,520,288,520,232,232,7,225,194,31
90166,Lipljan,13,,326,148,326,178,178,2,176,125,51
90166,Lipljan,14,,217,33,217,184,184,0,184,151,33
90166,Lipljan,15,,227,108,227,119,119,5,114,82,32
90166,Lipljan,16,,174,100,174,74,74,0,74,50,24
90166,Lipljan,17,,229,113,229,116,116,0,116,100,16
90166,Lipljan,18,,622,522,622,100,100,0,100,60,40
90182,Novo Brdo,1,,153,43,153,110,110,0,110,103,7
90182,Novo Brdo,2,,231,36,231,195,195,3,192,169,23
90182,Novo Brdo,3,,200,58,200,142,142,0,142,133,9
90182,Novo Brdo,4,,58,0,58,58,58,3,55,46,9
90182,Novo Brdo,5,,255,73,255,182,182,1,181,155,26
90182,Novo Brdo,6,,136,32,136,104,104,3,101,89,12
90204,Obilić,1,,266,151,266,115,115,5,110,68,42
90204,Obilić,2,,313,129,313,184,184,2,182,99,83
90204,Obilić,3,,521,411,521,110,110,2,108,65,43
90204,Obilić,4,,159,116,159,43,43,0,43,38,5
90204,Obilić,5,,146,106,146,40,40,0,40,18,22
90204,Obilić,6,,338,218,338,120,120,2,118,111,7
90204,Obilić,7,,122,101,122,21,21,0,21,16,5
90204,Obilić,8,,639,460,639,179,179,3,176,149,27
90204,Obilić,9,,561,356,561,205,205,2,203,166,37
90204,Obilić,10,,116,79,116,37,37,1,36,29,7
90212,Orahovac,1,,401,159,401,242,242,5,237,167,70
90212,Orahovac,2,,453,202,453,251,251,1,250,212,38
90239,Peć,1,,135,78,135,57,57,1,56,22,34
90239,Peć,2,,145,52,145,93,93,0,93,63,30
90239,Peć,3,,183,68,189,115,115,3,112,70,42
90239,Peć,4,,131,48,131,83,83,3,80,52,28
90255,Prizren,1,,180,10,180,170,170,1,169,157,12
90263,Priština,1,,572,341,572,231,231,0,231,204,27
90263,Priština,2,,486,326,486,160,160,2,158,141,17
90263,Priština,3,,474,313,474,161,161,2,159,126,33
90263,Priština,4,,480,304,480,176,176,3,173,131,42
90263,Priština,5,,520,295,520,225,225,4,221,175,46
90263,Priština,6,,674,414,674,260,260,0,260,206,54
90263,Priština,7,,227,138,227,89,89,1,88,79,9
90263,Priština,8,,525,320,525,205,205,0,205,166,39
90263,Priština,9,,127,54,127,73,73,2,71,67,4
90263,Priština,10,,126,96,126,30,30,0,30,24,6
90263,Priština,11,,202,191,202,11,11,0,11,11,0
90263,Priština,12,,355,323,355,32,32,0,32,31,1
90263,Priština,13,,171,134,171,37,37,1,36,34,2
90263,Priština,14,,152,118,152,34,34,0,34,34,0
90263,Priština,15,,155,112,155,43,43,0,43,36,7
90263,Priština,16,,275,153,275,122,122,0,122,104,18
90263,Priština,17,,325,117,325,208,208,1,207,186,21
90263,Priština,18,,290,138,290,152,152,1,151,115,36
90263,Priština,19,,514,267,514,247,247,4,243,166,77
90263,Priština,20,,374,209,374,165,165,2,163,106,57
90263,Priština,21,,226,109,226,117,117,0,117,96,21
90263,Priština,22,,268,87,268,181,181,3,178,137,41
90263,Priština,23,,197,133,197,64,64,0,64,57,7
90263,Priština,24,,298,265,298,33,33,1,32,21,11
90263,Priština,25,,238,159,238,79,79,0,79,56,23
90263,Priština,26,,205,113,205,92,92,1,91,73,18
90271,Srbica,1,,132,43,132,89,89,0,89,39,50
90271,Srbica,2,,201,83,201,118,118,0,118,64,54
90298,Kosovska Mitrovica,1,,1167,877,1167,290,290,6,284,162,122
90298,Kosovska Mitrovica,2,,1005,752,1005,253,253,4,249,181,68
90298,Kosovska Mitrovica,3,,563,414,563,149,149,1,148,95,53
90298,Kosovska Mitrovica,4,,1522,1183,1522,339,339,2,337,239,98
90298,Kosovska Mitrovica,5,,478,349,478,129,129,1,128,103,25
90298,Kosovska Mitrovica,6,,1163,1031,1163,132,132,0,132,72,60
90298,Kosovska Mitrovica,7,,1040,810,1040,230,230,3,227,151,76
90298,Kosovska Mitrovica,8,,1132,872,1132,260,260,2,258,172,86
90298,Kosovska Mitrovica,9,,597,456,597,141,141,1,140,97,43
90298,Kosovska Mitrovica,10,,1056,728,1056,328,328,2,326,249,77
90298,Kosovska Mitrovica,11,,903,713,903,190,190,1,189,133,56
90298,Kosovska Mitrovica,12,,334,225,334,109,109,1,108,71,37
90298,Kosovska Mitrovica,13,,1230,1198,1230,32,32,1,31,8,23
90298,Kosovska Mitrovica,14,,1604,1591,1604,13,13,0,13,2,11
90298,Kosovska Mitrovica,15,,823,670,823,153,153,3,150,124,26
90298,Kosovska Mitrovica,16,,586,514,586,72,72,0,72,50,22
90298,Kosovska Mitrovica,17,,790,693,790,97,97,1,96,81,15
90298,Kosovska Mitrovica,18,,1006,940,1007,66,66,2,64,53,11
90298,Kosovska Mitrovica,19,,347,221,347,126,126,1,125,116,9
90298,Kosovska Mitrovica,20,,646,560,646,86,86,0,86,75,11
90298,Kosovska Mitrovica,21,,1402,1040,1402,362,362,2,360,303,57
90328,Štrpce,1,,463,263,463,200,200,0,200,146,54
90328,Štrpce,2,,490,340,490,150,150,4,146,114,32
90328,Štrpce,3,,559,324,559,235,235,4,231,170,61
90328,Štrpce,4,,460,237,460,223,223,2,221,185,36
90328,Štrpce,5,,521,143,521,378,378,2,376,302,74
90328,Štrpce,6,,494,282,494,212,212,1,211,161,50
90328,Štrpce,7,,719,402,719,317,317,4,313,197,116
90328,Štrpce,8,,609,376,609,233,233,3,230,162,68
90328,Štrpce,9,,621,306,621,315,315,6,309,213,96
90328,Štrpce,10,,243,122,243,121,121,0,121,98,23
90328,Štrpce,11,,125,63,125,62,62,0,62,45,17
90328,Štrpce,12,,333,203,333,130,130,0,130,102,28
90328,Štrpce,13,,748,379,748,369,369,2,367,279,88
90328,Štrpce,14,,129,29,129,100,100,1,99,85,14
90328,Štrpce,15,,127,56,127,71,71,0,71,57,14
90328,Štrpce,16,,624,418,624,206,206,1,205,149,56
90328,Štrpce,17,,296,197,296,99,99,0,99,82,17
90352,Zvečan,1,,1476,939,1476,537,537,2,535,373,162
90352,Zvečan,2,,1156,768,1156,388,388,8,380,283,97
90352,Zvečan,3,,707,421,707,286,286,0,286,203,83
90352,Zvečan,4,,847,667,847,180,180,1,179,139,40
90352,Zvečan,5,,474,270,474,204,204,4,200,131,69
90352,Zvečan,6,,494,357,494,137,137,1,136,62,74
90352,Zvečan,7,,523,294,523,229,229,2,227,183,44
90352,Zvečan,8,,858,470,858,388,388,6,382,294,88
90352,Zvečan,9,,275,160,275,115,115,2,113,96,17
90352,Zvečan,10,,419,299,419,120,120,2,118,94,24
